,store_id,store_id_only_num,store_name,booking,receipt,blog,total
0,s1518997092,1518997092,준오헤어 노원사거리점,2004,3,15,2022
1,s1571970153,1571970153,차홍룸 홍대점,1998,1,10,2009
2,s1142939643,1142939643,차홍룸 용산센트럴점,1861,3,11,1875
3,s1481443590,1481443590,차홍룸 용산점,1536,2,11,1549
4,s1177346002,1177346002,차홍룸 양재점,1363,1,10,1374
5,s1906769677,1906769677,차홍룸 삼성점,1320,2,10,1332
6,s1524045876,1524045876,차홍룸 신논현점,1278,2,10,1290
7,s32692564,32692564,CHOP헤어 신천점,963,1,11,975
8,s1088094452,1088094452,차홍룸 목동점,948,3,10,961
9,s1746174193,1746174193,차홍룸 신촌점,931,1,10,942
10,s1967312452,1967312452,차홍룸 한남점,878,1,10,889
11,s38642772,38642772,제오헤어 신촌점,849,2,10,861
12,s21331306,21331306,CHOP헤어 잠실점,773,1,11,785
13,s1349483891,1349483891,차홍룸 잠실점,723,2,11,736
14,s944203444,944203444,유니크바이,682,1,11,694
15,s37653586,37653586,박승철헤어스투디오 신촌점,679,1,10,690
16,s1026108143,1026108143,에이엠톤 본점,677,1,10,688
17,s1567835311,1567835311,박승철헤어스투디오 신림점,572,1,10,583
18,s34983865,34983865,준오헤어 서울대입구역점,565,2,10,577
19,s950329204,950329204,메종드아이디헤어 CBS목동점,549,11,10,570
20,s34585445,34585445,리안헤어 중랑역점,534,2,11,547
21,s32264673,32264673,이진헤어 노량진점,521,2,8,531
22,s37101503,37101503,CHOPHAIR 대치점,518,1,11,530
23,s37911640,37911640,박준뷰티랩 종각역점,499,1,10,510
24,s11726491,11726491,준오헤어 강남2호점,480,1,11,492
25,s33874401,33874401,더 부띠끄 건대점,469,3,15,487
26,s63165318,63165318,준오헤어 방배역점,470,2,11,483
27,s1646635576,1646635576,차홍룸 대치점,472,1,10,483
28,s11780868,11780868,이철헤어커커 명동1호점,469,1,13,483
29,s37207278,37207278,준오헤어 노원역점,455,1,10,466
30,s35608702,35608702,그라티아,451,1,10,462
31,s13522443,13522443,박승철헤어스투디오 홍대점,437,10,11,458
32,s1147929912,1147929912,더 부띠끄 강남점,429,1,15,445
33,s33050015,33050015,제오헤어 이수점,427,1,11,439
34,s13154187,13154187,이철헤어커커 신림점,434,2,1,437
35,s11830399,11830399,쟝피엘헤어 서울대입구역점,426,1,10,437
36,s276866921,276866921,리안헤어 신내점,421,2,10,433
37,s1476629369,1476629369,파리지엔헤어 명동점,403,1,11,415
38,s13457551,13457551,준오헤어 이수역점,398,5,11,414
39,s31197568,31197568,파란헤어 강남본점,391,1,11,403
40,s920634429,920634429,박준뷰티랩 서울대입구역점,389,1,10,400
41,s30868013,30868013,이철헤어커커 구로디지털단지역점,378,1,10,389
42,s31384717,31384717,CHOP헤어 홍대점,377,1,10,388
43,s13186001,13186001,박승철헤어스투디오 상도점,375,2,10,387
44,s33576116,33576116,다온헤어 건대점,366,1,15,382
45,s90606567,90606567,준오헤어 문정역점,366,1,11,378
46,s36763183,36763183,준오헤어 홍대2호점,365,1,10,376
47,s21387752,21387752,쟝피엘헤어 낙성대 라이프스타일점,361,1,10,372
48,s1665527436,1665527436,리안헤어 상봉역점,356,1,6,363
49,s1894939931,1894939931,헤어더뷰 서울대입구역점,351,1,10,362
50,s37207269,37207269,준오헤어 잠실롯데월드몰점,338,1,10,349
51,s35708601,35708601,이철헤어커커 목동홈플러스점,336,1,10,347
52,s35608684,35608684,진미장살롱,326,6,11,343
53,s33938157,33938157,준오헤어 가로수길점,315,9,11,335
54,s1329001579,1329001579,헤어더뷰 강남점,320,1,10,331
55,s36351504,36351504,준오헤어 구의역점,312,1,10,323
56,s31213050,31213050,리안헤어 신림점,309,1,12,322
57,s38233601,38233601,준오헤어 강남레드점,309,1,10,320
58,s902588037,902588037,박준뷰티랩 신대방삼거리점,309,1,10,320
59,s13184969,13184969,이철헤어커커 명동2호점,296,1,15,312
60,s222169546,222169546,프롬에이 아현뉴타운점,298,1,11,310
61,s11726494,11726494,준오헤어 강남1호점,297,1,10,308
62,s30809001,30809001,이철헤어커커 가양홈플러스점,295,1,10,306
63,s36072086,36072086,리안헤어 구의역점,293,1,10,304
64,s33851197,33851197,리안헤어 이수역점,296,1,7,304
65,s12053151,12053151,라리엔 명동점,280,1,12,293
66,s1045893423,1045893423,박승철헤어스투디오 이수역점,260,21,10,291
67,s36199663,36199663,살롱오디너리,276,2,10,288
68,s1407062583,1407062583,리안헤어 아차산역점,280,1,6,287
69,s37775650,37775650,살롱 드 리본,275,1,11,287
70,s1148956991,1148956991,헤어로맨스,276,1,10,287
71,s37484299,37484299,리안헤어 한양대점,270,1,15,286
72,s1173397154,1173397154,차홍룸 압구정점,270,1,10,281
73,s37207281,37207281,준오헤어 강남우성점,268,1,10,279
74,s1867773103,1867773103,박준뷰티랩 영등포역점,267,1,10,278
75,s37076679,37076679,이철헤어커커 대치점,266,1,11,278
76,s1722437544,1722437544,리안헤어 군자역점,263,1,7,271
77,s391359158,391359158,준오헤어 강남우성사거리점,257,1,12,270
78,s1785850786,1785850786,살롱드부띠크 페이버릿점,254,1,15,270
79,s38501265,38501265,라리엔 강남점,258,1,11,270
80,s18742865,18742865,제오헤어 대방점,257,1,11,269
81,s1703840024,1703840024,토니앤가이 목동2호점,255,1,13,269
82,s1173497337,1173497337,미채움헤어,255,1,13,269
83,s91786087,91786087,보그헤어 화곡점,244,13,10,267
84,s36624634,36624634,로코코헤어,253,1,11,265
85,s38525801,38525801,박승철헤어스투디오 당산역점,252,1,10,263
86,s1115349689,1115349689,로이드밤 천호점,253,2,7,262
87,s1937022489,1937022489,에이컨셉 이수점,250,1,10,261
88,s671212338,671212338,메종드아이디헤어 문정하비오점,214,31,11,256
89,s1164456562,1164456562,보그헤어 잠실새내역점,241,1,13,255
90,s1818157839,1818157839,레뮤즈,244,1,10,255
91,s13502147,13502147,토니앤가이 목동점,241,1,13,255
92,s1179531843,1179531843,로이드밤 응암역점,241,1,9,251
93,s37700083,37700083,안다미로헤어 마포점,237,1,11,249
94,s1225426775,1225426775,순시키헤어 홍대점,231,2,11,244
95,s37746945,37746945,이퀄다이아몬드,230,1,12,243
96,s37917838,37917838,살롱드부띠크 본점,227,1,15,243
97,s38003572,38003572,듀벨헤어,230,1,10,241
98,s1387964242,1387964242,준오헤어 가든준오 용산아이파크몰점,225,1,11,237
99,s36663115,36663115,헤어아티스트m 용산점,230,1,5,236
100,s1491063937,1491063937,리안헤어 봉화산역점,225,1,10,236
101,s783468304,783468304,최가을헤어드레서 화곡점,225,1,10,236
102,s37890502,37890502,그로잉살롱 본점,220,1,14,235
103,s38425836,38425836,더본헤어 동부시장점,220,1,11,232
104,s466972737,466972737,리소헤어 서울대입구점,220,1,10,231
105,s35913513,35913513,보그헤어 우장산역점,215,1,10,226
106,s1169633050,1169633050,리안헤어 장안사거리점,218,1,6,225
107,s38641784,38641784,반트헤어살롱 암사점,213,1,10,224
108,s13527417,13527417,이철헤어커커 교대점,212,1,10,223
109,s1006407012,1006407012,더부띠끄 라운지점,211,1,11,223
110,s1278852855,1278852855,CHOP헤어 송파점,210,1,11,222
111,s36364106,36364106,리소헤어 건대점,209,1,10,220
112,s36992294,36992294,리즈 헤어라벨르 홍대점,217,1,1,219
113,s557191513,557191513,준오헤어 낙성대역점,207,2,10,219
114,s11887616,11887616,데몬헤어 이대점,206,1,12,219
115,s410893842,410893842,보그헤어 아현역점,207,1,10,218
116,s37471730,37471730,데이바이데이정헤어,206,1,10,217
117,s892105169,892105169,플랜에이치 홍대점,205,1,11,217
118,s1127629589,1127629589,준오헤어 가든준오IFC몰점,204,2,10,216
119,s1421030381,1421030381,아이디헤어 아현뉴타운점,203,1,10,214
120,s21029049,21029049,이철헤어커커 잠실신천2호점,202,1,10,213
121,s37207287,37207287,준오헤어 종합운동장사거리점,200,1,10,211
122,s215119768,215119768,박준뷰티랩 사당점,203,1,5,209
123,s37207279,37207279,준오헤어 노원문화의거리점,189,7,11,207
124,s30944129,30944129,에이난 홍대점,193,1,11,205
125,s1921760811,1921760811,에이컨셉 강남2호점,193,1,10,204
126,s686653075,686653075,이가자헤어비스 공덕역점,194,1,9,204
127,s1418714277,1418714277,에피소드 헤어스토리,199,1,1,201
128,s37370153,37370153,준오헤어 목동41타워점,183,7,11,201
129,s961858874,961858874,어반그라운드헤어 상왕십리점,188,1,10,199
130,s1674221445,1674221445,박승철헤어스투디오 송파헬리오시티점,187,1,10,198
131,s32800168,32800168,준오헤어 천호역점,187,1,10,198
132,s1097198281,1097198281,리안헤어 사당로데오점,165,23,9,197
133,s1315188725,1315188725,헤어살롱 기쁘다 건대점,180,2,15,197
134,s1847594617,1847594617,오캄 현대백화점 미아점,186,1,10,197
135,s37097895,37097895,오다헤어 이태원로데오점,186,1,9,196
136,s1700494654,1700494654,준오헤어 강남역스퀘어점,183,3,10,196
137,s1638916447,1638916447,리안헤어 명일역점,190,1,4,195
138,s36997020,36997020,보그헤어 천호역점,180,1,12,193
139,s1087406696,1087406696,이진헤어 본점,179,1,11,191
140,s1045056143,1045056143,준오헤어 선릉테헤란로점,179,1,11,191
141,s11721479,11721479,와이미용실,189,1,1,191
142,s34689376,34689376,준오헤어 돈암1호점,179,1,10,190
143,s37687262,37687262,리안헤어 문정법조타운점,186,1,3,190
144,s36878425,36878425,보그헤어 신도림역점,178,1,10,189
145,s35013646,35013646,헤어벨리시마 건대점,177,1,11,189
146,s1445855462,1445855462,아버헤어 홍대 롯데호텔점,174,3,10,187
147,s34052371,34052371,H STYLE 헤어살롱 노량진점,175,1,10,186
148,s31116556,31116556,박승철헤어스투디오 타임스퀘어점,176,1,8,185
149,s37112551,37112551,Hairby우호우상 신천점,173,1,11,185
150,s36432431,36432431,떼뜨베르,172,1,11,184
151,s250475690,250475690,살롱에이 방배역1호점,176,1,7,184
152,s578554202,578554202,클라스헤어,172,1,11,184
153,s37207595,37207595,아이디헤어 은평뉴타운점,168,3,12,183
154,s1311049269,1311049269,보그헤어 창동역점,176,1,6,183
155,s36266113,36266113,제오헤어 여의도점,172,1,9,182
156,s18588871,18588871,준오헤어 선릉역1호점,169,1,11,181
157,s1140023479,1140023479,로이드밤 방화역점,170,2,8,180
158,s20080730,20080730,오유헤어&네일디자인,166,1,11,178
159,s37035964,37035964,박승철헤어스투디오 신도림홈플러스점,166,1,10,177
160,s31977823,31977823,더퍼스트헤어 안암본점,160,1,15,176
161,s34667384,34667384,이철헤어커커 오목교역점,166,1,9,176
162,s13574247,13574247,준오헤어 잠실점,163,1,10,174
163,s36084366,36084366,더헤어 감동,163,1,10,174
164,s1154632643,1154632643,어반그라운드헤어 by다비 왕십리역점,162,2,10,174
165,s34689172,34689172,헤어아티스트M 영등포점,163,1,10,174
166,s37207280,37207280,준오헤어 서울대샤로수길점,165,1,7,173
167,s37207290,37207290,준오헤어 왕십리역1호점,161,1,10,172
168,s37192368,37192368,어반그라운드헤어 약수점,158,1,10,169
169,s368515517,368515517,박승철헤어스투디오 마곡나루역점,157,1,11,169
170,s1027341085,1027341085,코벨헤어 본점,156,1,10,167
171,s36827152,36827152,리안헤어 미아사거리역점,151,1,15,167
172,s35523634,35523634,트리플헤어디자인,155,1,10,166
173,s1337516936,1337516936,준오헤어 남부터미널역점,155,1,10,166
174,s82379273,82379273,라트리헤어 스파힐 강남베르점,152,1,12,165
175,s33431131,33431131,준오헤어 건대역2호점,153,1,11,165
176,s1869573828,1869573828,공간헤어,154,1,10,165
177,s1942566726,1942566726,아쥴헤어 왕십리역점,158,1,5,164
178,s1545310362,1545310362,홀릭오다 용산점,152,1,11,164
179,s34883044,34883044,제오헤어 구로디지털단지점,155,1,8,164
180,s1936355480,1936355480,12월애헤어,153,1,10,164
181,s717923768,717923768,하룸헤어 성신여대본점,152,1,10,163
182,s1431983836,1431983836,리안헤어 석촌역점,154,1,8,163
183,s33617901,33617901,오다헤어 보광점,150,1,11,162
184,s1078206800,1078206800,지노헤어 동대문점,151,2,9,162
185,s21399206,21399206,스윕헤어,151,1,10,162
186,s37695687,37695687,박승철헤어스투디오 종로점,150,1,10,161
187,s35977788,35977788,준오헤어 영등포점,150,1,10,161
188,s11889727,11889727,쿠헤어,145,1,15,161
189,s1148613743,1148613743,샵꽁뜨,153,1,5,159
190,s1528078134,1528078134,박준뷰티랩 송파헬리오시티점,144,1,13,158
191,s37207298,37207298,준오헤어 대학로점,146,2,10,158
192,s37207293,37207293,준오헤어 천호로데오점,146,1,10,157
193,s31583340,31583340,토니앤가이 홍제점,145,1,11,157
194,s38474260,38474260,쓰담헤어,145,1,11,157
195,s37936029,37936029,준오헤어 강남화이트점,144,2,10,156
196,s38314163,38314163,김송정머리터 중랑점,143,1,11,155
197,s21074755,21074755,데몬헤어 홍대점,143,1,11,155
198,s319576515,319576515,이철헤어커커 당산역점,144,1,10,155
199,s35623536,35623536,헤어아티스트M 구로역점,144,1,10,155
200,s37207272,37207272,준오헤어 명동2호점,143,1,10,154
201,s1017263718,1017263718,아르미헤어 상봉타워 블랙점,145,1,8,154
202,s11726505,11726505,준오헤어 대치점,143,1,10,154
203,s416973904,416973904,살롱드에드가,147,1,5,153
204,s13144668,13144668,제오헤어 오류점,141,1,11,153
205,s1596435812,1596435812,아이디헤어 강남511타워점,126,15,10,151
206,s1848449747,1848449747,이철헤어커커 송파헬리오시티,140,1,10,151
207,s37413618,37413618,아이디헤어 반포3호점,138,2,11,151
208,s11830137,11830137,박준뷰티랩 강남역점,139,1,10,150
209,s19963039,19963039,이철헤어커커 서울대입구점,139,1,10,150
210,s81329705,81329705,아이디헤어 대치점,137,3,10,150
211,s37896710,37896710,반함,138,1,10,149
212,s1809226710,1809226710,박승철헤어스투디오 미아사거리점,137,1,10,148
213,s673942969,673942969,G9 hair,137,1,10,148
214,s37997702,37997702,박승철헤어스투디오 신방화역점,136,1,11,148
215,s37160820,37160820,헤어바이반룬하우트 대치점,136,1,10,147
216,s36420528,36420528,박승철헤어스투디오 잠실홈플러스점,135,1,11,147
217,s1834620751,1834620751,이가자헤어비스 종로점,135,1,10,146
218,s18233978,18233978,준오헤어 사당역점,135,1,10,146
219,s1166710785,1166710785,티지헤어 오테르길음역점,134,1,11,146
220,s30853065,30853065,살롱드프롬 연신내점,133,1,11,145
221,s33937612,33937612,리안헤어 가양자이타워점,134,1,10,145
222,s13332490,13332490,준오헤어 중계은행사거리점,133,1,10,144
223,s122597850,122597850,영등포미용실엘라인,133,1,10,144
224,s36294720,36294720,브로스헤어살롱,133,1,10,144
225,s577678599,577678599,바오 본점,133,1,10,144
226,s266594009,266594009,리안헤어 마곡역점,132,1,10,143
227,s205473861,205473861,준오헤어 반포점,128,4,11,143
228,s37673396,37673396,박준뷰티랩 구로디지털역점,136,1,6,143
229,s1203957780,1203957780,메이봄헤어 강남본점,130,3,10,143
230,s33696507,33696507,준오헤어 삼성역점,131,1,10,142
231,s1148792779,1148792779,로이드밤 불광역점,139,1,2,142
232,s37426933,37426933,최가을헤어드레서 공덕점,128,3,11,142
233,s602642067,602642067,준오헤어 명일역점,130,1,10,141
234,s1210064106,1210064106,박준뷰티랩 뚝섬유원지역점,138,1,2,141
235,s1524176850,1524176850,라트리헤어 스파힐 강동베르점,129,1,11,141
236,s13372500,13372500,박준뷰티랩 이수역점,128,1,12,141
237,s587514840,587514840,리안헤어 방이역점,137,1,3,141
238,s36443298,36443298,박공헤어 약수하우스,130,1,10,141
239,s1861231987,1861231987,로이드밤 구파발역점,130,1,10,141
240,s1489662508,1489662508,로이드밤 신길점,131,2,7,140
241,s1067087521,1067087521,준오헤어 건대역1호점,129,1,10,140
242,s52738799,52738799,아이디헤어 롯데몰은평점,127,3,10,140
243,s38758519,38758519,하츠헤어,130,1,9,140
244,s36333472,36333472,라브리지헤어 명동점,122,2,15,139
245,s36683944,36683944,살롱에이 목동점,128,1,10,139
246,s36294833,36294833,베이바이허슬기 그린점,128,1,10,139
247,s36561078,36561078,커밍헤어,128,1,10,139
248,s21518365,21518365,파란헤어 강남허브점,127,1,10,138
249,s854312254,854312254,박공헤어 금호하우스,129,1,8,138
250,s1803659110,1803659110,준오헤어 은평롯데몰점,126,1,10,137
251,s1426279116,1426279116,수인스타일 삼성점,124,1,12,137
252,s37673416,37673416,준오헤어 강남4호점,126,1,10,137
253,s1847784815,1847784815,아리스타타헤어,126,1,10,137
254,s36795613,36795613,헤어살롱오브 본점,124,2,11,137
255,s37793766,37793766,더 부띠끄 왕십리점,123,1,13,137
256,s13306273,13306273,이가자헤어비스 수색이마트점,129,1,7,137
257,s1799794742,1799794742,박준뷰티랩 신풍역,125,1,10,136
258,s35657690,35657690,보그헤어 구로지밸리몰점,125,1,10,136
259,s1426906449,1426906449,에이엠톤 합정점,132,1,3,136
260,s37221648,37221648,써드힐 헤어스파,131,1,4,136
261,s36782134,36782134,머시헤어 3호점,125,1,10,136
262,s1516095669,1516095669,리소헤어 홍대2호점,125,1,10,136
263,s35338095,35338095,살롱드에비뉴 사가정점,117,2,16,135
264,s1060808484,1060808484,로이드밤 방배역점,126,1,8,135
265,s702774211,702774211,더크라운헤어 서교점,123,1,11,135
266,s1876700203,1876700203,뷰티어스 남부터미널점,122,1,11,134
267,s32514393,32514393,박승철헤어스투디오 가산역1호점,127,1,6,134
268,s35178693,35178693,제오헤어 신내점,123,1,9,133
269,s166461227,166461227,용산미용실살롱오디너리,121,1,11,133
270,s1460080199,1460080199,이철헤어커커 금천구청롯데캐슬점,121,1,10,132
271,s1089479751,1089479751,리프레쉬헤어,121,1,10,132
272,s1853195556,1853195556,탁미연헤어,120,1,10,131
273,s1542871582,1542871582,이가자헤어비스 잠실새내역점,127,1,3,131
274,s1865773646,1865773646,다윈헤어,124,1,5,130
275,s35507020,35507020,제오헤어 건대점,118,1,10,129
276,s18692364,18692364,리안헤어 노량진점,117,1,10,128
277,s36912626,36912626,에떼르넬헤어살롱 사옥점,117,1,10,128
278,s1188332883,1188332883,로이드밤 우장산역점,116,1,10,127
279,s33944112,33944112,살롱드프롬 성신여대점,115,1,11,127
280,s1952451604,1952451604,이철헤어커커 후암점,125,1,1,127
281,s33373559,33373559,살롱드 비쥬벨헤어,115,1,10,126
282,s37207295,37207295,준오헤어 합정메세나폴리스점,114,2,10,126
283,s1976237263,1976237263,아르미헤어 YMS타워 본점,114,1,11,126
284,s1317510527,1317510527,스프레이헤어,121,1,3,125
285,s12978047,12978047,순시키헤어 밤헤드,112,1,11,124
286,s31531064,31531064,더감동 미아본점,113,1,10,124
287,s68672740,68672740,ZS헤어살롱,112,2,10,124
288,s36655536,36655536,제오헤어 화곡역점,113,1,10,124
289,s1959539654,1959539654,탐스런헤어 탐스퀘어점,114,1,7,122
290,s38667038,38667038,아마릴리스헤어살롱,106,1,14,121
291,s33252527,33252527,반룬하우트 길동점,110,1,10,121
292,s1433702552,1433702552,프로젝트라빠헤어 홍대3호점,111,1,9,121
293,s1780225531,1780225531,박공헤어 서울숲하우스,118,1,2,121
294,s1913653523,1913653523,로이드밤 교대점,109,2,10,121
295,s37408783,37408783,리안헤어 명지대점,117,1,2,120
296,s791805874,791805874,어반그라운드헤어 구파발역점,109,1,10,120
297,s816971052,816971052,제오헤어 장승배기역점,114,1,4,119
298,s13372499,13372499,박준뷰티랩 총신대점,103,1,15,119
299,s20103169,20103169,준오헤어 신촌점,108,1,10,119
300,s1285676611,1285676611,리안헤어 구의역2호점,108,1,10,119
301,s38310407,38310407,넌데일리,108,1,10,119
302,s1248134203,1248134203,박승철헤어스투디오 성신여대점,108,1,10,119
303,s35940444,35940444,박승철헤어스투디오 연신내점,117,1,1,119
304,s1730779484,1730779484,리안헤어 태릉입구역점,112,1,6,119
305,s31295769,31295769,리안헤어발산점,106,2,10,118
306,s36663176,36663176,리소헤어 강남점,107,1,10,118
307,s36740040,36740040,지노헤어 한양대점,107,1,10,118
308,s1675766998,1675766998,라라엘헤어,113,1,4,118
309,s38676962,38676962,지노헤어 숭실대1호점,108,1,9,118
310,s1820918651,1820918651,더퍼스트헤어 미아점,110,1,7,118
311,s18569655,18569655,준오헤어 당산역점,105,2,10,117
312,s1480588120,1480588120,준오헤어 신내점,109,1,7,117
313,s37008926,37008926,리소헤어 연세로점,105,1,10,116
314,s35386890,35386890,준오헤어 신림역2호점,105,1,10,116
315,s1424120514,1424120514,이철헤어커커 강남차밍점,114,1,1,116
316,s18383548,18383548,프리스타일헤어 등촌점,104,1,11,116
317,s11724319,11724319,박승철헤어스투디오 문정점,105,1,10,116
318,s305535418,305535418,달공이네 미장원,102,3,11,116
319,s21787792,21787792,제오헤어 군자점,105,1,10,116
320,s38648039,38648039,리소헤어 신림점,105,1,10,116
321,s18119346,18119346,니어앤디어 hair salon,105,1,10,116
322,s11726509,11726509,준오헤어 돈암2호점,110,1,4,115
323,s13372485,13372485,박준뷰티랩 방배점,104,1,10,115
324,s1541655992,1541655992,살롱드프롬 연신내화이트점,108,1,6,115
325,s37869663,37869663,이가자헤어비스 잠실롯데점,102,2,10,114
326,s529777006,529777006,리소헤어 이대점,102,1,11,114
327,s36779229,36779229,준오헤어 왕십리역 2호점 VIP,103,1,10,114
328,s13060126,13060126,양리헤어,103,1,10,114
329,s31357462,31357462,준오헤어 이대2호점,103,1,10,114
330,s1287988275,1287988275,이가자헤어비스 신림삼모타워점,102,1,11,114
331,s12985219,12985219,리브헤어,101,2,11,114
332,s1514215732,1514215732,그레,102,1,10,113
333,s1820078779,1820078779,스타밀리언살롱,99,3,11,113
334,s1685040384,1685040384,박승철헤어스투디오 독산롯데캐슬점,105,1,6,112
335,s12053288,12053288,프랑크프로보 명동,100,1,11,112
336,s21697598,21697598,에즈헤어라운지 화곡점,101,1,10,112
337,s37383715,37383715,준오헤어 길동역점,101,1,10,112
338,s1949930228,1949930228,별빛오름 노량진점,102,1,9,112
339,s33956745,33956745,오다헤어 경리단길점,99,1,11,111
340,s31936151,31936151,이가자헤어비스 현대시티아울렛가산점,100,1,10,111
341,s36504199,36504199,헤어그리미,109,1,1,111
342,s1695963033,1695963033,보그헤어 중랑역점,100,1,10,111
343,s1241650692,1241650692,데몬헤어 신촌점,99,1,10,110
344,s13106020,13106020,리안헤어 잠실역점,99,1,10,110
345,s1356188133,1356188133,살롱드프롬 금호점,107,1,2,110
346,s1509308410,1509308410,준오헤어 신사역세로수길점,102,2,6,110
347,s36642935,36642935,아이벨르팜므 신방화역점,99,1,10,110
348,s331581426,331581426,세븐에비뉴 합정점,97,1,11,109
349,s34937257,34937257,헤어스튜디오J,97,1,10,108
350,s18735108,18735108,에이치스타일 서대문점,96,1,11,108
351,s1726024609,1726024609,박승철헤어스투디오 잠실새내점,97,1,10,108
352,s18562520,18562520,마끼에 타임스퀘어점,104,1,3,108
353,s31207007,31207007,나인토파즈헤어,92,5,11,108
354,s1590537785,1590537785,라리엔 가로수길점,95,1,11,107
355,s19570592,19570592,아이디헤어 래미안퍼스티지점,96,1,10,107
356,s1884435332,1884435332,제이슨프로헤어,100,2,5,107
357,s36516389,36516389,아름다운작업장,91,1,15,107
358,s37236557,37236557,오다헤어 중앙대점,99,1,7,107
359,s1181641308,1181641308,준오헤어 홍대입구역점,96,1,10,107
360,s1018164032,1018164032,리안헤어 중계은행사거리점,103,1,2,106
361,s1764039225,1764039225,헤어제3공간,96,1,9,106
362,s919261817,919261817,박승철헤어스투디오 교보합정점,90,5,11,106
363,s38526290,38526290,수아라헤어 가좌1호점,102,1,3,106
364,s36276109,36276109,제이드헤어,97,1,8,106
365,s263963767,263963767,헤어살롱나루 양재역점,94,1,10,105
366,s34349373,34349373,준오헤어 동대문홈플러스점,100,1,4,105
367,s38508020,38508020,헤어아티스트M 대치점,94,1,10,105
368,s219678611,219678611,마음이통하다헤어살롱,94,1,10,105
369,s1222327123,1222327123,리안헤어 도봉한신점,101,1,2,104
370,s31476031,31476031,더 퍼스트헤어 고려대점,88,1,15,104
371,s18744162,18744162,준오헤어 이대3호점,93,1,10,104
372,s21029110,21029110,살롱루즈 가로수길점,84,1,19,104
373,s1574340058,1574340058,박호준헤어 일원점,99,1,4,104
374,s13376858,13376858,머시헤어 2호점,96,1,6,103
375,s1853807979,1853807979,하움,92,1,10,103
376,s1725443048,1725443048,세븐에비뉴 강남1호점,92,1,10,103
377,s18714950,18714950,살롱에이 중대점,92,1,10,103
378,s13372497,13372497,박준뷰티랩 장안점,89,1,13,103
379,s36420632,36420632,엘세븐헤어 신촌연대점,92,1,10,103
380,s66838411,66838411,리안헤어 신길역점,96,1,6,103
381,s33261907,33261907,코제트헤어컬러 성신여대점,92,1,9,102
382,s36883352,36883352,살롱 드 옥스,85,1,15,101
383,s1217069041,1217069041,리소헤어 이수점,90,1,10,101
384,s1258477274,1258477274,로이드밤 구로점,94,1,6,101
385,s1679738120,1679738120,준오헤어 내방역점,90,1,10,101
386,s1944592669,1944592669,헤어아티스트M 마포구청역점,97,1,3,101
387,s35689427,35689427,제오헤어 방배점,92,1,8,101
388,s1709750229,1709750229,제오헤어 신용산역점,87,1,12,100
389,s37566546,37566546,설렘 미용실,85,3,12,100
390,s1579776147,1579776147,메종드아이디헤어 서울숲점,87,3,10,100
391,s1257940967,1257940967,리안헤어 굽은다리역점,88,1,11,100
392,s38304870,38304870,더살롱,89,1,10,100
393,s649134941,649134941,바른살롱,83,1,15,99
394,s37532329,37532329,제다헤어 외대점,93,1,5,99
395,s13391459,13391459,칸토헤어,88,1,10,99
396,s13268650,13268650,벨라아띠 잠실미용실,86,1,11,98
397,s38701480,38701480,장루이다비드 에스뷰테라 옥수점,88,1,9,98
398,s249295828,249295828,헤어바이반룬하우트 망원역점,87,1,10,98
399,s21116373,21116373,에끌레르헤어,86,1,11,98
400,s1781825651,1781825651,살롱드조각 헤어스튜디오,85,1,11,97
401,s36792874,36792874,박승철헤어스투디오 왕십리역점,86,1,10,97
402,s37165580,37165580,반에스,85,1,11,97
403,s36898101,36898101,박승철헤어스투디오 염창역점,90,1,6,97
404,s1026458598,1026458598,제인헤어,85,1,10,96
405,s35111987,35111987,이철헤어커커 발산역점,88,1,7,96
406,s37450128,37450128,살롱드마샬 명동점,84,1,11,96
407,s36016150,36016150,살롱드노바,84,1,11,96
408,s1708710038,1708710038,감각을더하다,92,1,3,96
409,s13075445,13075445,엔비헤어살롱,80,1,15,96
410,s1143880589,1143880589,휴이엠헤어 상봉역점,89,1,6,96
411,s38654778,38654778,베아르시 광화문점,85,1,10,96
412,s827159285,827159285,제오헤어 마곡나루역점,85,1,10,96
413,s38531460,38531460,지노헤어 숭실대2호점,91,1,4,96
414,s896340668,896340668,메종드아이디헤어 반포자이점,82,4,10,96
415,s38287149,38287149,이가자헤어비스 위례점,84,1,10,95
416,s35413542,35413542,마타헤어,83,1,11,95
417,s833387128,833387128,누벨바그헤어살롱 신도림점,85,1,9,95
418,s37891176,37891176,어반그라운드헤어 이태원점,83,1,11,95
419,s1630742846,1630742846,라라헤어,90,1,3,94
420,s11829338,11829338,류영헤어투비,82,2,10,94
421,s1335417444,1335417444,어반그라운드헤어 화곡역점,89,1,4,94
422,s37774914,37774914,티지헤어 오테르길음뉴타운점,90,1,3,94
423,s21054630,21054630,준오헤어 연신내점,83,1,10,94
424,s1302439523,1302439523,박공헤어 화양세종하우스,83,1,10,94
425,s37811854,37811854,NOWHAIRLAB,82,1,10,93
426,s1274215500,1274215500,살롱드22,82,1,10,93
427,s1118247162,1118247162,보그헤어 공릉역점,84,1,8,93
428,s36246648,36246648,The감동 수유점,82,1,10,93
429,s38404559,38404559,헤어아티스트M 공덕점,82,1,10,93
430,s37174940,37174940,제오헤어 서울대입구역점,81,1,11,93
431,s13580504,13580504,아베다안스헤어,80,1,11,92
432,s35092298,35092298,준오헤어 한티역점,81,1,10,92
433,s777921841,777921841,보그헤어 신촌역점,81,1,10,92
434,s35014004,35014004,제오헤어 마포점,81,1,10,92
435,s390732261,390732261,살롱드프롬 염창역점,89,1,2,92
436,s1080986806,1080986806,하루헤어 등촌점,87,1,4,92
437,s1633734825,1633734825,미용실by지아,84,1,7,92
438,s1489614655,1489614655,아름다움그리다,81,1,10,92
439,s1083058117,1083058117,달콤헤어,81,1,10,92
440,s34240295,34240295,헤어인카페 왕십리점,80,1,11,92
441,s1774300466,1774300466,뜨뜨 헤어살롱,84,1,6,91
442,s38667533,38667533,리안헤어 대흥점,80,1,10,91
443,s31887065,31887065,헤어아티스트M 상도점,84,1,6,91
444,s1836392918,1836392918,브로시스,77,3,11,91
445,s34356248,34356248,마끼에 미아롯데백화점점,80,1,10,91
446,s32302000,32302000,이철헤어커커 낙성대점,78,2,11,91
447,s1311155727,1311155727,리뷰띠헤어,79,1,10,90
448,s13332574,13332574,준오헤어 신내홈플러스점,86,1,3,90
449,s37559416,37559416,맨케이션,74,1,15,90
450,s32537821,32537821,헤어톡톡,78,1,11,90
451,s1792694677,1792694677,헤어카리스 가양점,82,1,6,89
452,s33595496,33595496,리안헤어 신대방삼거리역점,77,1,11,89
453,s36639698,36639698,리안헤어 하나로클럽신촌점,77,1,11,89
454,s63788703,63788703,박준뷰티랩 우장산역점,81,1,6,88
455,s1427376047,1427376047,머리생각,77,1,10,88
456,s13154188,13154188,준오헤어 신림역1호점,76,1,11,88
457,s36233391,36233391,제오헤어 구로디지털태평양점,76,1,11,88
458,s1324215398,1324215398,라트리헤어 스파힐 마곡나루베르점,74,1,13,88
459,s36667743,36667743,영등포미용실 W셀렉션,76,1,11,88
460,s37932727,37932727,제오헤어 신도림역점,85,1,2,88
461,s31144138,31144138,헤어아티스트M 중앙대점,83,1,4,88
462,s37486385,37486385,헤어앤손뇨,77,1,10,88
463,s1552658056,1552658056,신승원컷앤컷 홍대점,77,1,10,88
464,s38738214,38738214,장루이다비드 에스뷰테라 남산타운점,72,5,11,88
465,s1267976857,1267976857,리안헤어 미아역점,76,1,10,87
466,s37420666,37420666,이철헤어커커 이노시티상봉점,76,1,10,87
467,s37547151,37547151,루이헤어코프 방이점,76,1,10,87
468,s35637556,35637556,리안헤어 송파역점,78,1,8,87
469,s1847227067,1847227067,끌레뷰헤어 신림점,77,1,9,87
470,s1057888782,1057888782,박승철헤어스투디오 가산벚꽃로점,79,1,7,87
471,s1160576488,1160576488,헤어더뷰 성신여대점,76,1,10,87
472,s1716761144,1716761144,이안헤어,75,1,11,87
473,s31905815,31905815,박승철헤어스투디오 가산역2호점,85,1,1,87
474,s35708383,35708383,오랑헤어 압구정본점,70,1,15,86
475,s33688459,33688459,이가자헤어비스 상봉홈플러스점,83,1,2,86
476,s36772322,36772322,리안헤어 이수이마트점,83,1,2,86
477,s31394131,31394131,가위스토커 1호점,76,5,5,86
478,s35346829,35346829,아톰헤어 성신여대본점,75,1,10,86
479,s32581885,32581885,제오헤어 등촌점,75,1,10,86
480,s1540740349,1540740349,박준뷰티랩 명동점,74,1,11,86
481,s1589712190,1589712190,블루밍헤어,74,1,11,86
482,s1243603571,1243603571,다온헤어,75,1,10,86
483,s1721295875,1721295875,리소헤어 대학로점,72,4,10,86
484,s37346275,37346275,이지헤어 연남점,74,1,10,85
485,s1039364681,1039364681,파란헤어 약수점,74,1,10,85
486,s38448390,38448390,켄맨즈헤어,74,1,10,85
487,s37886017,37886017,까리노헤어,79,1,5,85
488,s20721082,20721082,이철헤어커커 현대백화점 디큐브시티,82,1,1,84
489,s994749209,994749209,아이벨르팜므 발산역점,73,1,10,84
490,s1074109723,1074109723,디자인차이,73,1,10,84
491,s1822958774,1822958774,32비긴,73,1,10,84
492,s34635838,34635838,이철헤어커커 여의도역점,73,1,10,84
493,s32359012,32359012,프리티살롱 청담점,73,1,10,84
494,s756987638,756987638,펠리아 서울양평점,79,1,3,83
495,s13526047,13526047,머시헤어 1호점,74,1,8,83
496,s648099365,648099365,리소헤어 유플렉스점,74,2,7,83
497,s36898233,36898233,제오헤어 쌍문점,74,1,7,82
498,s20757940,20757940,엥비떼헤어,71,1,10,82
499,s36229775,36229775,리안헤어 수유점,70,1,11,82
500,s35787913,35787913,알렉산드르 드 파리,71,1,10,82
501,s1234677764,1234677764,박승철헤어스투디오 개포동역점,70,1,10,81
502,s1478174367,1478174367,헤어바이수정,79,1,1,81
503,s1435513848,1435513848,살롱 소냐르,77,1,3,81
504,s36520352,36520352,박준뷰티랩 신도림점,69,1,11,81
505,s1162301865,1162301865,엘브라운,70,1,10,81
506,s1438697852,1438697852,박승철헤어스투디오 강남대로점,74,1,6,81
507,s1729625714,1729625714,팔레트에이치 강남역1호점,64,6,10,80
508,s683037712,683037712,준오헤어 은평뉴타운점,69,1,10,80
509,s1309687209,1309687209,메종101 석촌점,74,2,4,80
510,s34356652,34356652,리안헤어 남구로역점,71,1,8,80
511,s36935683,36935683,쓰리스토리 도산점,69,1,10,80
512,s1123234327,1123234327,박승철헤어스투디오 천호교보점,72,1,7,80
513,s37202829,37202829,박승철헤어스투디오 마곡점,75,1,4,80
514,s37086244,37086244,루미오뷰티하우스,68,1,11,80
515,s1327681758,1327681758,레토헤어,76,1,3,80
516,s36379550,36379550,리소헤어 홍대점,69,1,10,80
517,s1487843297,1487843297,어반그라운드헤어 옥수점,76,1,3,80
518,s36410250,36410250,헤어아티스트M 마포점,69,1,10,80
519,s35751302,35751302,리안헤어 구로디지털밸리점,69,1,10,80
520,s1186554086,1186554086,보아스 헤어,69,2,8,79
521,s33912842,33912842,준오헤어 코엑스도심공항점,72,2,5,79
522,s35807451,35807451,보그헤어 보라매역점,67,1,11,79
523,s1522616726,1522616726,리안헤어 문배리첸시아점,77,1,1,79
524,s36740195,36740195,박승철헤어스투디오 보라매역점,67,1,10,78
525,s1200676448,1200676448,로이드밤 당산점,74,1,3,78
526,s37006001,37006001,룬헤어,67,1,10,78
527,s38212129,38212129,더순수헤어,66,1,11,78
528,s36379375,36379375,이철헤어커커 신방화역점,67,1,10,78
529,s955485454,955485454,리소헤어 숙대점,68,1,9,78
530,s33758240,33758240,본샵,62,1,15,78
531,s38781023,38781023,현헤어,67,1,10,78
532,s34856806,34856806,아티스틱,75,1,2,78
533,s35152514,35152514,나즈 앤 나빈,67,1,10,78
534,s37873650,37873650,지노헤어 당산역점,66,1,10,77
535,s325908825,325908825,데꼬헤살롱,66,1,10,77
536,s528781115,528781115,아이디헤어 강서점,42,25,10,77
537,s37341469,37341469,준오헤어 명동1호점,66,1,10,77
538,s1409953793,1409953793,유니헤어,66,1,10,77
539,s35823151,35823151,엘리시아헤어수유본점,69,1,7,77
540,s38695517,38695517,엘세븐헤어 신대방삼거리역점,70,2,5,77
541,s36410910,36410910,김민진헤어방배점,75,1,1,77
542,s37207273,37207273,준오헤어 명동3호점,65,1,10,76
543,s32692782,32692782,박승철헤어스투디오 마포점,64,1,11,76
544,s11568230,11568230,뮤사이 살롱드점,60,2,14,76
545,s21705467,21705467,가꿈헤어드림 수유점,64,1,11,76
546,s13452756,13452756,헤어그라피 가든파이브점,65,1,10,76
547,s156197985,156197985,권홍헤어 대치점,65,1,10,76
548,s1294065498,1294065498,에이치앤헤어살롱,71,1,3,75
549,s36432392,36432392,봄오후2시,64,1,10,75
550,s34745234,34745234,제이비헤어스토리 청담점,59,1,15,75
551,s34936810,34936810,버스커헤어,59,1,15,75
552,s20082615,20082615,이철헤어커커 공덕KCC점,68,1,6,75
553,s36416940,36416940,미오름헤어 1호점,68,1,6,75
554,s1810654556,1810654556,큐헤어 서울양평점,66,1,8,75
555,s21647383,21647383,준오헤어 강서구청점,63,2,10,75
556,s36816979,36816979,살롱드벨레자,62,2,10,74
557,s18080028,18080028,한솔헤어,63,1,10,74
558,s35188390,35188390,디탐헤어 건대점,63,1,10,74
559,s1293282749,1293282749,헤어아르떼,68,1,5,74
560,s13523247,13523247,헤어아티스트M 당산점,67,1,6,74
561,s34150686,34150686,박준뷰티랩 청담본점,60,4,10,74
562,s1393076831,1393076831,메이드바이알 헤어살롱,62,1,11,74
563,s20753472,20753472,제오헤어 까치산점,62,1,11,74
564,s1192085748,1192085748,메이제이헤어,62,1,11,74
565,s11893908,11893908,아이디헤어 잠원점,64,1,9,74
566,s36836417,36836417,아르헤헤어,64,1,9,74
567,s18241567,18241567,데이앤라이프,63,1,10,74
568,s1666833494,1666833494,수아라헤어 공덕애오개점,62,1,10,73
569,s37703580,37703580,제오헤어 문정점,62,1,10,73
570,s37486158,37486158,리소헤어 성신여대점,62,1,10,73
571,s33373954,33373954,지노헤어 동대문2호점,62,1,10,73
572,s1454391306,1454391306,도담헤어,71,1,1,73
573,s758510678,758510678,리안헤어 경희궁자이점,71,1,1,73
574,s36932774,36932774,플랜에이치 압구정 로데오 본점,61,1,11,73
575,s1154399564,1154399564,차홍룸 방배점,61,2,10,73
576,s35438726,35438726,에즈헤어라운지 외대점,63,1,9,73
577,s38332367,38332367,이가자헤어비스 용산아이파크몰점,68,1,4,73
578,s1546532852,1546532852,메종드헤어0403 대치점,64,1,7,72
579,s35307002,35307002,리안헤어 신도림역점,62,1,9,72
580,s1951570598,1951570598,박준뷰티랩 서초역점 (서초애비뉴점),70,1,1,72
581,s36525561,36525561,데생헤어,59,1,11,71
582,s1875407103,1875407103,오롯이빛나는,58,1,12,71
583,s33956809,33956809,네추럴데이즈 신림점,60,1,10,71
584,s11893910,11893910,아이디헤어 반포1호점,58,2,11,71
585,s1386626243,1386626243,이룩헤어,60,1,10,71
586,s13182113,13182113,이철헤어커커 반포자이점,65,1,5,71
587,s38344983,38344983,헤어뜰애 노원역점,60,1,10,71
588,s36547565,36547565,4D헤어 낙성대본점,61,1,9,71
589,s1360908976,1360908976,어반그라운드헤어 금호사거리점,62,1,7,70
590,s11737510,11737510,에이컨셉 청담 본점,57,1,12,70
591,s1836011609,1836011609,어반그라운드헤어 신대방삼거리점,67,1,2,70
592,s1675552683,1675552683,어반그라운드헤어 송파하비오점,65,1,4,70
593,s12955749,12955749,이가자헤어비스 은평이마트점,68,1,1,70
594,s21673286,21673286,이가자헤어비스 하월곡이마트점,62,1,7,70
595,s1817714377,1817714377,차홍룸 서초점,58,1,10,69
596,s13503170,13503170,인디헤어 더 스타일,58,1,10,69
597,s38420161,38420161,준오헤어 코엑스몰점,58,1,10,69
598,s1943036392,1943036392,이철헤어커커 길음뉴타운점,53,1,15,69
599,s1186558016,1186558016,리안헤어 수서역점,66,1,2,69
600,s1551262095,1551262095,이룸헤어,63,1,5,69
601,s18658549,18658549,세종헤어 올림픽점,57,1,10,68
602,s34589973,34589973,헤어팰리스 잠실관광호텔점,66,1,1,68
603,s13483836,13483836,비비헤어 미아사거리,56,1,11,68
604,s36369158,36369158,준오헤어 여의도IFC몰점,55,3,10,68
605,s21250698,21250698,제이메이드헤어,56,1,10,67
606,s38464341,38464341,헬로헤어 고져스,56,1,10,67
607,s35787994,35787994,박승철헤어스투디오 흑석점,61,1,5,67
608,s1845353098,1845353098,유이프,55,1,10,66
609,s1978282800,1978282800,플랜에이치 고척점,55,1,10,66
610,s13223022,13223022,지오헤어 목동점,49,1,15,65
611,s1738445705,1738445705,파니샵 당산역점,53,1,11,65
612,s43065995,43065995,이가자헤어비스 명일역점,56,1,8,65
613,s35195114,35195114,박승철헤어스투디오 성수이마트점,54,1,10,65
614,s1792847018,1792847018,살롱에필,58,1,6,65
615,s31148625,31148625,아톰헤어 성북동점,54,1,10,65
616,s13053252,13053252,킹스턴 맨즈헤어,57,1,7,65
617,s34666096,34666096,살롱에이 목동2호점,60,1,4,65
618,s37207274,37207274,준오헤어 명동4호점,52,2,10,64
619,s1771207986,1771207986,블랑쉬헤어,60,1,3,64
620,s37207296,37207296,준오헤어 홍대1호점,52,1,11,64
621,s1831086081,1831086081,헤어아티스트M 오금점,56,1,7,64
622,s1616430046,1616430046,살롱엔제이,53,1,10,64
623,s18492833,18492833,리안헤어 오류점,53,1,10,64
624,s36538689,36538689,리안헤어 먹골점,61,1,2,64
625,s34087367,34087367,박준뷰티랩 신림점,51,1,11,63
626,s1075655705,1075655705,Tm hair,56,1,6,63
627,s36823575,36823575,리안헤어 당곡사거리점,51,1,11,63
628,s36823352,36823352,제오헤어 천호점,60,1,2,63
629,s33758657,33758657,리안헤어 고척점,58,1,4,63
630,s1444387734,1444387734,아이헤어 고려대점,52,1,10,63
631,s1396061564,1396061564,나나헤어 가로수길점,52,1,10,63
632,s1246510501,1246510501,살롱드반하다,52,1,10,63
633,s34761405,34761405,프로젝트라빠헤어 까치산점,57,1,5,63
634,s37725915,37725915,민티헤어,52,1,9,62
635,s236106315,236106315,헤어벨 홍대점,51,1,10,62
636,s37402747,37402747,리소헤어 구로디지털단지점,51,1,10,62
637,s1024553340,1024553340,바나나미용실,60,1,1,62
638,s37157138,37157138,베이바이허슬기 오렌지점,51,1,10,62
639,s1709681683,1709681683,아메살롱,51,1,10,62
640,s36823743,36823743,리안헤어 보라매역점,51,1,10,62
641,s31055441,31055441,리안헤어 화곡점,55,1,6,62
642,s1395945792,1395945792,H studio,59,1,2,62
643,s13149886,13149886,한스헤어 선릉점,55,1,6,62
644,s1785564927,1785564927,라브리지헤어 마곡역점,51,1,10,62
645,s38721139,38721139,아디움헤어,51,1,10,62
646,s1721208877,1721208877,에코쟈뎅 천호점,57,1,3,61
647,s19477710,19477710,스타일헤어,49,2,10,61
648,s35928923,35928923,하헤리 양재점,50,1,10,61
649,s38530809,38530809,리안헤어 이수2호점,59,1,1,61
650,s32711121,32711121,H스타일 영등포구청역점,49,1,11,61
651,s35787629,35787629,리엑스류헤어샵 문정훼미리점,54,1,6,61
652,s1672713470,1672713470,로코코헤어,51,1,9,61
653,s11574385,11574385,준오헤어 이대1호점,49,1,11,61
654,s31083214,31083214,이가자헤어비스 강동점,52,1,8,61
655,s38463438,38463438,플로어헤어,49,1,10,60
656,s1318869590,1318869590,그랑데 에이치 헤어살롱,54,1,5,60
657,s1182105300,1182105300,휴이엠헤어 가좌역점,56,1,3,60
658,s18229567,18229567,라비에벨헤어살롱 이대점,48,1,11,60
659,s38467033,38467033,리소헤어 신천점,51,1,8,60
660,s858516609,858516609,살롱드디헤어,58,1,1,60
661,s1839681882,1839681882,헤어바이봄,57,1,2,60
662,s1647484731,1647484731,비에스헤어갤러리,48,2,10,60
663,s37233147,37233147,리안헤어 강변역점,49,1,10,60
664,s1480349339,1480349339,그로잉살롱 양재점,47,1,11,59
665,s1931497287,1931497287,보그헤어 응암역점,48,1,10,59
666,s33996790,33996790,가위스토커 2호점,52,1,6,59
667,s36668140,36668140,네추럴데이즈 낙성대점,52,1,6,59
668,s37213263,37213263,준오헤어 수유역점,57,1,1,59
669,s37811980,37811980,지노헤어 명지대점,53,1,5,59
670,s1334614925,1334614925,헤어살롱나루 양재점,48,1,10,59
671,s1310438377,1310438377,H STYLE 고덕점,51,1,7,59
672,s1263174371,1263174371,살루트헤어,48,1,10,59
673,s32435882,32435882,장루이다비드 잠실롯데캐슬점,54,1,4,59
674,s1879949698,1879949698,순수 선릉점,48,1,10,59
675,s37657801,37657801,이훈ALL30000 신림점,51,2,5,58
676,s1354807334,1354807334,로이드밤 목동역점,53,1,4,58
677,s1140810732,1140810732,휴고헤어,49,1,8,58
678,s1586921369,1586921369,몽상 선릉점,47,1,10,58
679,s30829655,30829655,박승철헤어스투디오 도봉빅마켓점,50,1,7,58
680,s38624012,38624012,리안헤어 뚝섬유원지역점,48,1,9,58
681,s1531719129,1531719129,제오헤어 약수역점,55,1,2,58
682,s1200996645,1200996645,베이바이허슬기 민트점,48,1,9,58
683,s1076411199,1076411199,러블리하우스헤어 남성2호점,53,1,4,58
684,s257883766,257883766,리안헤어 가산디지털단지역점,55,1,2,58
685,s33906866,33906866,리안헤어 문래점,47,1,10,58
686,s1492537469,1492537469,박승철헤어스투디오 선정릉역점,50,5,2,57
687,s935200296,935200296,리엑스류헤어샵 잠실점,54,1,2,57
688,s1559246976,1559246976,어반헤어스튜디오,45,1,11,57
689,s35842145,35842145,박승철헤어스투디오 롯데월드몰점,46,1,10,57
690,s644362569,644362569,J헤어,46,1,10,57
691,s20508836,20508836,준오헤어 강서홈플러스점,54,1,2,57
692,s33078297,33078297,리안헤어 월곡역점,55,1,1,57
693,s1040126865,1040126865,예쁘다 늘,53,1,3,57
694,s38703972,38703972,리안헤어 가양역로드점,46,1,10,57
695,s1606213518,1606213518,메종드 마샬 용산 센트럴,50,1,6,57
696,s21219789,21219789,에뜨레헤어,45,1,11,57
697,s1983154371,1983154371,인연 헤어,46,1,10,57
698,s1913011806,1913011806,로이드밤 약수역점,54,1,2,57
699,s37653292,37653292,릴리프헤어 전농점,46,1,10,57
700,s36868273,36868273,이진헤어 대림역점,50,1,5,56
701,s57986041,57986041,브로스헤어,45,1,10,56
702,s35913731,35913731,리안헤어 상암월드컵파크점,52,1,3,56
703,s37823510,37823510,박승철헤어스투디오 광나루역점,45,1,10,56
704,s1726634504,1726634504,살롱드픽스 사가정점,51,1,4,56
705,s1356349071,1356349071,고코,54,1,1,56
706,s1966437288,1966437288,본 살롱,45,1,10,56
707,s1608382474,1608382474,토니앤가이 마곡역점,45,1,10,56
708,s1737548149,1737548149,살롱하우스 바네프,45,1,10,56
709,s1226296303,1226296303,경자,44,1,10,55
710,s1594339846,1594339846,봄바람살롱살롱,53,1,1,55
711,s1194297393,1194297393,엥비떼헤어 신논현점,44,1,10,55
712,s138617320,138617320,파부헤어,50,1,4,55
713,s38729463,38729463,젤르헤어,44,1,10,55
714,s1452775567,1452775567,정현헤어,49,1,5,55
715,s1823478174,1823478174,얼번스트리트 블라썸점,51,1,3,55
716,s11675363,11675363,진우헤어 연희점,44,1,10,55
717,s37383893,37383893,미노헤어,44,1,10,55
718,s38737541,38737541,하이루나,43,1,10,54
719,s18467324,18467324,헤어카리스 선릉본점,43,1,10,54
720,s1174930685,1174930685,비비드헤어,43,1,10,54
721,s37929845,37929845,요한헤어,43,1,10,54
722,s1697463647,1697463647,서울대입구 미용실 헤어비앙꼬,50,1,3,54
723,s1174649525,1174649525,박준뷰티랩 가양역점,49,1,4,54
724,s37549268,37549268,바바헤어 까치산점,49,3,1,53
725,s36643148,36643148,조헤어,42,1,10,53
726,s1349768039,1349768039,에피파니헤어,42,1,10,53
727,s34116276,34116276,본헤어샵,46,1,6,53
728,s13327235,13327235,수인스타일 논현점,37,1,15,53
729,s1963580655,1963580655,로뎀나무숲헤어샵,51,1,1,53
730,s1968635926,1968635926,블랑드블랑,42,1,10,53
731,s31307677,31307677,리안헤어 목동사거리점,42,1,10,53
732,s33444985,33444985,리안헤어 구산역점,42,1,10,53
733,s1163382011,1163382011,헤어 리케이,42,1,10,53
734,s1120462973,1120462973,홍대미용실 A&H 홍대본점,42,1,10,53
735,s1900558305,1900558305,더아름다움,47,1,4,52
736,s1229880298,1229880298,컷플,41,1,10,52
737,s1514870692,1514870692,로브 디자인 살롱,50,1,1,52
738,s11702117,11702117,HMTT미용실,42,1,9,52
739,s36624332,36624332,리안헤어 문정역점,48,1,3,52
740,s1670171572,1670171572,베이바이허슬기 퍼플점,41,1,10,52
741,s37405009,37405009,더예쁜머리 강남점,39,1,12,52
742,s665063357,665063357,박승철헤어스투디오 선릉역점,44,1,7,52
743,s38781510,38781510,토리헤어 암사역점,45,1,6,52
744,s731080586,731080586,제오헤어 공덕점,41,1,9,51
745,s767541894,767541894,리안헤어 아현역점,45,1,5,51
746,s36285527,36285527,모즈헤어 숙대점,47,1,3,51
747,s13348981,13348981,탄포포헤어,35,1,15,51
748,s572130193,572130193,리안헤어 영등포구청점,48,1,2,51
749,s21244213,21244213,에떼르넬헤어살롱 홍대점,40,1,10,51
750,s921871121,921871121,진헤어,37,1,13,51
751,s20621101,20621101,제오헤어 신길점,49,1,1,51
752,s37895631,37895631,지노헤어 신촌점,42,1,8,51
753,s19958198,19958198,고아라헤어케어 2호점,44,1,6,51
754,s20406421,20406421,산뜻헤어,49,1,1,51
755,s1429679306,1429679306,바오 상봉2호점,40,1,10,51
756,s1441651769,1441651769,블라잇 헤어,40,1,10,51
757,s36998626,36998626,이민헤어혼 신길점,47,1,3,51
758,s91569921,91569921,글래드헤어,45,1,4,50
759,s31391648,31391648,리안헤어 구수동사거리점,42,1,7,50
760,s1663363985,1663363985,리챠드프로헤어 강남교보점,39,1,10,50
761,s35652427,35652427,준오헤어 선릉역2호점,48,1,1,50
762,s1127441514,1127441514,베이바이허슬기 블랑점,44,1,5,50
763,s1180189607,1180189607,베이바이허슬기 레몬점,39,1,10,50
764,s37992862,37992862,제오헤어 개봉역점,47,1,1,49
765,s38462333,38462333,비클래시헤어,38,1,10,49
766,s1789128255,1789128255,로이드밤 중화역점,47,1,1,49
767,s11730537,11730537,쟈끄데상쥬 신천점,38,1,10,49
768,s1043717131,1043717131,벨라헤어,37,1,11,49
769,s144692934,144692934,박준뷰티랩 마곡역점,42,1,6,49
770,s978299821,978299821,박준뷰티랩 성균관대점,47,1,1,49
771,s33626434,33626434,토니앤가이 연희점,42,1,6,49
772,s13157549,13157549,이철헤어커커 신림포도몰점,39,1,9,49
773,s1163507885,1163507885,르블랑헤어,39,1,9,49
774,s17947654,17947654,가오다0927,38,1,10,49
775,s1507582889,1507582889,엔살롱,41,1,6,48
776,s1406862992,1406862992,예쁘다헤어,35,1,12,48
777,s37288519,37288519,박승철헤어스투디오 남가좌점,46,1,1,48
778,s1112194891,1112194891,나로헤어,46,1,1,48
779,s38248627,38248627,뮤즈헤어살롱,43,1,4,48
780,s21824587,21824587,박준뷰티랩 구일점,39,1,8,48
781,s804826552,804826552,앤아트헤어살롱,36,1,10,47
782,s1424578736,1424578736,Layer712,39,1,7,47
783,s1409456833,1409456833,조이드헤어,42,1,4,47
784,s553272782,553272782,1108SALON,35,1,11,47
785,s13177579,13177579,이철헤어커커 숙대점,43,1,3,47
786,s1325928865,1325928865,박승철헤어스투디오 까치산역점,36,1,10,47
787,s37127135,37127135,도고헤어,34,1,12,47
788,s37853341,37853341,더원스헤어,35,2,10,47
789,s21872405,21872405,준오헤어 강변역점,36,1,10,47
790,s1523542447,1523542447,어포스트로피헤어 홍대점,36,1,10,47
791,s13343512,13343512,박찬헤어스테이지,34,1,11,46
792,s1546415973,1546415973,애쉬헤어디자인,44,1,1,46
793,s36797097,36797097,맷블랙헤어성신여대점,35,1,10,46
794,s198564376,198564376,박승철헤어스투디오 공덕역점,44,1,1,46
795,s1202716300,1202716300,라로블 시흥점,37,1,8,46
796,s32779485,32779485,한결헤어,35,1,10,46
797,s19805574,19805574,매스티지헤어,31,1,14,46
798,s415458891,415458891,바비수앤,35,1,10,46
799,s11724290,11724290,박승철헤어스투디오 관악롯데백화점,35,1,10,46
800,s1992513927,1992513927,인더살롱 수유본점,35,1,10,46
801,s38473521,38473521,한스헤어 선릉2호점,40,1,5,46
802,s1662019488,1662019488,더세리 바이 세리마마,35,1,10,46
803,s1862001349,1862001349,이철헤어커커 잠실나루역점,35,1,10,46
804,s37420402,37420402,에이제이헤어,44,1,1,46
805,s37561998,37561998,니우,37,1,8,46
806,s1956585634,1956585634,박공헤어 경리단하우스,42,1,3,46
807,s32219467,32219467,제오헤어 압구정점,42,1,3,46
808,s1299270783,1299270783,킵온헤어,42,1,3,46
809,s33605859,33605859,cafe de hair,35,1,9,45
810,s32692629,32692629,제오헤어 낙성대점,33,1,11,45
811,s31812214,31812214,Bambi hair,41,1,3,45
812,s1241490868,1241490868,에이솜헤어,42,1,2,45
813,s37281408,37281408,제오헤어 금호점,42,1,2,45
814,s1229343087,1229343087,제오헤어 영등포구청역점,40,1,4,45
815,s20406565,20406565,우현증메르시,34,1,10,45
816,s1869720681,1869720681,어반트랜드 잠실 신천점,30,1,14,45
817,s33920232,33920232,이철헤어커커 강동홈플러스점,43,1,1,45
818,s13125028,13125028,버블스타일,33,1,11,45
819,s34754422,34754422,롤헤어 신림본점,34,1,10,45
820,s1723718252,1723718252,아렘살롱,41,1,3,45
821,s37281720,37281720,카벨로,34,1,10,45
822,s36901313,36901313,헤어바이일리오스,32,1,11,44
823,s34551074,34551074,리안헤어 강서구청점,33,1,10,44
824,s37417639,37417639,이철헤어커커 위례신도시점,38,1,5,44
825,s36462579,36462579,이철헤어커커 방학홈플러스점,42,1,1,44
826,s544697315,544697315,비본헤어&네일,34,1,9,44
827,s439136983,439136983,바바헤어 명일점,33,1,10,44
828,s1514720531,1514720531,열두 번의 봄,42,1,1,44
829,s32613863,32613863,리안헤어 신대방역점,33,1,10,44
830,s1105243478,1105243478,고운헤어,33,1,10,44
831,s20688327,20688327,리안헤어 당산역점,42,1,1,44
832,s36368926,36368926,박승철헤어스투디오 미아역점,42,1,1,44
833,s1870949889,1870949889,캄스컬러 망원역점,41,1,2,44
834,s1498762091,1498762091,하이에이치,42,1,1,44
835,s35111061,35111061,이철헤어커커 한성대역점,34,1,9,44
836,s1179632842,1179632842,더헤어숲,35,1,7,43
837,s1624819882,1624819882,이철헤어커커 금천홈플러스점,35,1,7,43
838,s1612975165,1612975165,어반제이슨 헤어,41,1,1,43
839,s1848328270,1848328270,어메이징헤어 오류점,39,1,3,43
840,s1897165625,1897165625,제오헤어 금천롯데캐슬점,37,1,5,43
841,s723682558,723682558,상수동화,32,1,10,43
842,s13547755,13547755,리안헤어 약수역점,40,1,2,43
843,s1162580394,1162580394,살롱드에꼬,32,1,10,43
844,s1418867718,1418867718,수아르떼헤어살롱,41,1,1,43
845,s1093180147,1093180147,리안헤어 마곡점,35,1,7,43
846,s37547146,37547146,찰스바버샵 홍대본점,35,1,7,43
847,s1160483950,1160483950,장루이다비드X에스뷰테라 홍대점,29,6,8,43
848,s1163682341,1163682341,수헤어살롱,32,1,10,43
849,s1363285759,1363285759,살롱드미미,34,1,8,43
850,s1674414357,1674414357,마틴헤어,32,1,10,43
851,s1376972950,1376972950,어바웃민 헤어,41,1,1,43
852,s1218416981,1218416981,Key of Hair,41,1,1,43
853,s1183342860,1183342860,네이처헤어 노원역점,34,2,6,42
854,s1415861459,1415861459,보그헤어 장승배기역점,39,1,2,42
855,s854831798,854831798,모즈헤어 망원역점,39,1,2,42
856,s1721572280,1721572280,에이컨셉 구의점,34,1,7,42
857,s817075450,817075450,W헤어 강변점,31,1,10,42
858,s1610103447,1610103447,헤어플레이스 반,31,1,10,42
859,s1358920021,1358920021,드웰헤어,31,1,10,42
860,s75269037,75269037,리안헤어 구파발점,34,1,7,42
861,s655820171,655820171,엔플럼,31,1,10,42
862,s34779213,34779213,주은헤어,31,1,10,42
863,s37541433,37541433,미랑컬헤어 마곡점,37,1,4,42
864,s37207289,37207289,준오헤어 신촌연대점,40,1,1,42
865,s1801423407,1801423407,수아라헤어 가좌 2호점,39,1,2,42
866,s1506415636,1506415636,리안헤어 성대시장점,33,1,8,42
867,s20780778,20780778,리안헤어 응암오거리점,35,1,6,42
868,s21844560,21844560,리오헤어,40,1,1,42
869,s37728645,37728645,We헤어 사당점,30,1,11,42
870,s1825809939,1825809939,리얼드살롱,31,1,10,42
871,s1751918469,1751918469,바이에린,40,1,1,42
872,s104962691,104962691,고아라헤어케어 강남점,31,1,10,42
873,s37578029,37578029,앤디샵179헤어,32,1,9,42
874,s1277258580,1277258580,쏭살롱,35,1,5,41
875,s35243915,35243915,리안헤어 어린이대공원역점,29,1,11,41
876,s1898682184,1898682184,플랜에이치 노원역28호점,30,1,10,41
877,s1087802735,1087802735,제이듀헤어,30,1,10,41
878,s1014623427,1014623427,리안헤어 쌍문역점,39,1,1,41
879,s34033972,34033972,반헤어,28,1,12,41
880,s35316799,35316799,소옴살롱,30,1,10,41
881,s1162852878,1162852878,나연헤어살롱,37,1,3,41
882,s1497459282,1497459282,물들이다,33,1,7,41
883,s1734246499,1734246499,리엑스류 베이직헤어샵,38,1,2,41
884,s35221564,35221564,네이처헤어 미아1호점,33,1,6,40
885,s1936869033,1936869033,리안헤어 창동하나로마트점,38,1,1,40
886,s37272262,37272262,캄스헤어,32,1,7,40
887,s35744015,35744015,모네살롱,29,1,10,40
888,s920006622,920006622,아이벨르팜므 상암DMC점,38,1,1,40
889,s21794944,21794944,동안 헤어메이크업,31,1,8,40
890,s1665731897,1665731897,리츠A 헤어살롱,37,1,2,40
891,s1682583107,1682583107,더데이즈헤어,29,1,10,40
892,s1904590932,1904590932,헤어코디,29,1,10,40
893,s128520914,128520914,클래시아 헤어,29,1,10,40
894,s1263391416,1263391416,권홍헤어 개포점,34,1,5,40
895,s1338254380,1338254380,비블헤어,31,2,7,40
896,s34958379,34958379,아이온헤어,29,1,10,40
897,s1252548007,1252548007,살롱 나래울,33,1,5,39
898,s38531034,38531034,론헤어 그루밍점,28,1,10,39
899,s37362199,37362199,마레헤어 시흥점,32,1,6,39
900,s1848818481,1848818481,라브리지헤어살롱 중계역점,36,1,2,39
901,s20080720,20080720,박승철헤어스투디오 개롱역점,27,1,11,39
902,s38709403,38709403,오다헤어 보라매역점,37,1,1,39
903,s13372477,13372477,박준뷰티랩 대치점,34,1,4,39
904,s1042079600,1042079600,아레스옴므,37,1,1,39
905,s32873201,32873201,크리헤어티브 대학동점,28,1,10,39
906,s35103686,35103686,HAROO HAIR,37,1,1,39
907,s1559941986,1559941986,제오헤어 마곡역점,34,1,4,39
908,s1983597820,1983597820,박승철헤어스투디오 장한평점,36,1,1,38
909,s518927291,518927291,SM헤어,27,1,10,38
910,s33770938,33770938,권홍헤어 경복궁점,26,1,11,38
911,s1086254966,1086254966,성수에뜰,27,1,10,38
912,s1103337314,1103337314,이진헤어 가산역점,35,1,2,38
913,s1851219487,1851219487,살롱드오밈,28,1,9,38
914,s736921305,736921305,살롱드블롱 발산역점,28,1,9,38
915,s35516093,35516093,스타일레드,30,1,7,38
916,s1459643637,1459643637,마끼에 신촌현대백화점,36,1,1,38
917,s1801634027,1801634027,플랜에이치 연남22호점,31,1,6,38
918,s36170590,36170590,이철헤어커커 은평뉴타운점,28,1,9,38
919,s1522160065,1522160065,살롱드미네스헤어,27,1,10,38
920,s13506300,13506300,이가자 헤어비스 이마트가양점,27,1,10,38
921,s1709228071,1709228071,아이앤투헤어 강서등촌점,36,1,1,38
922,s18088417,18088417,헤어위드동행,32,1,5,38
923,s1619226229,1619226229,헤어아티스트M 잠실점,27,1,9,37
924,s38738672,38738672,박승철헤어스투디오 푸른숲점,31,1,5,37
925,s1214266351,1214266351,아이벨르팜므 마곡점,33,1,3,37
926,s36096952,36096952,헤어아떼 송정역점,26,1,10,37
927,s38506907,38506907,2층미용실,26,1,10,37
928,s1989888542,1989888542,플랜에이치 숭실대역점,35,1,1,37
929,s1813051426,1813051426,다름헤어,26,1,10,37
930,s638727204,638727204,아이앤투헤어 목동오목교점,34,1,2,37
931,s1546213881,1546213881,어바웃9 서울스타점,26,1,10,37
932,s37203219,37203219,지노헤어 화곡역점,26,1,10,37
933,s32873054,32873054,헤어아티스트M 강서점,28,1,8,37
934,s431156768,431156768,미립헤어,26,1,10,37
935,s37561676,37561676,윤희헤어,35,1,1,37
936,s31155785,31155785,모즈헤어 아뜰리에점,33,1,3,37
937,s1373003927,1373003927,더순수헤어 2호점,25,1,11,37
938,s38551051,38551051,리안헤어 구일역점,32,1,4,37
939,s33279883,33279883,피움헤어,34,1,2,37
940,s37005693,37005693,헤어살롱디,27,1,9,37
941,s20741261,20741261,라이크효헤어,26,1,10,37
942,s37849508,37849508,제오헤어 수유역점,32,1,4,37
943,s1161443902,1161443902,순간의차이 헤어살롱,34,1,2,37
944,s35976657,35976657,모즈헤어 삼성점,26,1,10,37
945,s1369248602,1369248602,오름헤어,25,1,10,36
946,s197995254,197995254,헤어바이핑크밤,27,1,8,36
947,s11724354,11724354,박승철헤어스투디오 압구정로데오점,25,1,10,36
948,s1385602130,1385602130,리안헤어 오목교점,34,1,1,36
949,s1958193785,1958193785,제오헤어 묵동자이점,34,1,1,36
950,s38729516,38729516,로이앤제이드,25,1,10,36
951,s1295683489,1295683489,살롱데이 신금호점,30,1,5,36
952,s13417759,13417759,오송헤어,28,1,7,36
953,s18733471,18733471,어바웃9 대세점,24,1,11,36
954,s34269448,34269448,바이진 1호점,31,1,4,36
955,s38590880,38590880,LADINO,25,1,10,36
956,s1653134228,1653134228,디엑스헤어,31,1,4,36
957,s1972021029,1972021029,리엑스류헤어샵 엠스테이트점,32,1,3,36
958,s1192978483,1192978483,헤어바이반룬하우트 경희궁자이점,34,1,1,36
959,s38325650,38325650,노블헤어,25,1,10,36
960,s35658022,35658022,박승철헤어스투디오 상봉이마트점,24,1,11,36
961,s36240792,36240792,살롱제이미,25,1,10,36
962,s34541789,34541789,이철헤어커커 묵동자이점,24,1,10,35
963,s35246244,35246244,리안헤어 방이시장점,25,1,9,35
964,s37910595,37910595,달달헤어살롱,32,1,2,35
965,s1175939856,1175939856,헤어 마시멜로,24,1,10,35
966,s1313178348,1313178348,이가자헤어비스 신대방점,30,1,4,35
967,s391159117,391159117,에이치스타일 헤어살롱 구일점,33,1,1,35
968,s1573138180,1573138180,이아네헤어살롱,28,1,6,35
969,s13156427,13156427,산타클로스헤어,23,1,11,35
970,s1433600121,1433600121,우연히 헤어살롱,29,1,5,35
971,s356054426,356054426,러블리하우스헤어 남성1호점,32,1,2,35
972,s1415776549,1415776549,지노헤어 신당점,25,2,8,35
973,s1464877279,1464877279,슈블리헤어,24,1,10,35
974,s1292341957,1292341957,24시 H브라운헤어 양재역점,24,1,10,35
975,s1999948347,1999948347,청년 미장원,27,1,7,35
976,s37777901,37777901,메종드헤어0403 수유점,31,1,3,35
977,s1611486137,1611486137,살롱드키코 감동점,24,1,10,35
978,s36516707,36516707,라빈헤어 본점,24,1,10,35
979,s1441243314,1441243314,이끌림헤어,25,1,9,35
980,s1918780996,1918780996,헤어살롱오엠지,24,1,10,35
981,s324988973,324988973,최영헤어살롱,24,1,10,35
982,s1322402318,1322402318,보그헤어 마곡역점,24,1,10,35
983,s37272313,37272313,트리플엑스 대학로점,24,1,10,35
984,s37663737,37663737,베아르시 경복궁점,28,1,5,34
985,s31542867,31542867,까 홍대점,22,1,11,34
986,s1822270714,1822270714,헤어더쿠 스타트점,24,1,9,34
987,s1925984254,1925984254,세컨드샵 헤어앤스킨,24,1,9,34
988,s12052424,12052424,아뜰리에7,23,1,10,34
989,s32586877,32586877,이철헤어커커 동대문롯데몰점,29,1,4,34
990,s11881325,11881325,이철헤어커커 건대스타시티점,23,1,10,34
991,s593645057,593645057,온헤어,24,1,9,34
992,s1127356491,1127356491,이든헤어 강남역점,24,1,9,34
993,s1871321543,1871321543,은하수미장원,32,1,1,34
994,s1463793286,1463793286,준희네미장원,32,1,1,34
995,s37244319,37244319,살리고헤어,23,1,10,34
996,s19828392,19828392,에이치 헤어살롱,22,1,11,34
997,s35689198,35689198,리소헤어 노량진점,23,1,10,34
998,s1886962399,1886962399,살손헤어,26,1,7,34
999,s36642904,36642904,봄헤어살롱 2호점,26,1,6,33
1000,s1205770240,1205770240,우아보,23,1,9,33
1001,s1991883635,1991883635,토브헤어 숙대점,29,1,3,33
1002,s1946549441,1946549441,큐헤어 롯데월드타워점,31,1,1,33
1003,s1395726617,1395726617,라비에벨헤어 센트럴점,22,1,10,33
1004,s461446492,461446492,리오헤어 개롱역점,31,1,1,33
1005,s984427562,984427562,아이펠마르 공릉점,26,1,6,33
1006,s1662440206,1662440206,스위치존헤어,24,1,8,33
1007,s1883242123,1883242123,설헤어살롱,30,1,2,33
1008,s1693528036,1693528036,모던헤어,31,1,1,33
1009,s1209209315,1209209315,큐피헤어,27,1,5,33
1010,s240452678,240452678,이가자헤어비스 노원점,22,1,10,33
1011,s1483541567,1483541567,살롱드프롬 등촌점,31,1,1,33
1012,s34043430,34043430,이철헤어커커강변역점,26,1,6,33
1013,s1854845068,1854845068,하림헤어,23,1,9,33
1014,s645013168,645013168,오소소헤어,22,1,10,33
1015,s1475513100,1475513100,파랑룸Hair,30,1,2,33
1016,s1600705561,1600705561,토니앤가이 이촌한강맨션점,19,4,10,33
1017,s1133437814,1133437814,포도우 헤어,30,1,1,32
1018,s1048115129,1048115129,까르뜨헤어,23,1,8,32
1019,s32614179,32614179,더에이치스토리헤어,20,1,11,32
1020,s1971554561,1971554561,압구정헤어,21,1,10,32
1021,s1577598498,1577598498,지나헤어룸,30,1,1,32
1022,s1291777584,1291777584,살롱드픽스,26,1,5,32
1023,s35949494,35949494,이가자헤어비스 신대방삼거리점,30,1,1,32
1024,s1844774376,1844774376,보그헤어 명지대점,29,1,2,32
1025,s33956694,33956694,시트린헤어홍제점,24,1,7,32
1026,s1007162035,1007162035,유노이아헤어하우스,21,1,10,32
1027,s38555374,38555374,로미살롱,20,1,11,32
1028,s18853914,18853914,박준뷰티랩 답십리점,30,1,1,32
1029,s1349206785,1349206785,자르자헤어,20,1,11,32
1030,s1343561573,1343561573,가꿈헤어드림 명동점,22,1,9,32
1031,s36428331,36428331,민엘헤어,25,1,6,32
1032,s1213233631,1213233631,박승철헤어스투디오 아현점,29,1,1,31
1033,s32051267,32051267,모완10 헤어,25,1,5,31
1034,s1052294142,1052294142,주현헤어,25,1,5,31
1035,s1379926267,1379926267,구뜨,28,1,2,31
1036,s1374565634,1374565634,소담헤어살롱,20,1,10,31
1037,s17971465,17971465,디보쉬헤어 강변점,21,1,9,31
1038,s1857813531,1857813531,디유헤어,29,1,1,31
1039,s37495068,37495068,리안헤어 신방화역점,29,1,1,31
1040,s1674116431,1674116431,살롱분더바,19,1,11,31
1041,s1288033444,1288033444,론썸헤이드 독산사거리점,29,1,1,31
1042,s35824708,35824708,JJ헤어네일 수유,19,1,11,31
1043,s31360551,31360551,사틴헤어 갤러리아팰리스점,27,1,3,31
1044,s38729556,38729556,막스헤어 3호점,27,1,3,31
1045,s1285596239,1285596239,비비스헤어,28,1,2,31
1046,s1654628761,1654628761,빛남,20,1,10,31
1047,s1792743281,1792743281,디그헤어,26,1,4,31
1048,s1034545573,1034545573,페이지헤어,28,1,2,31
1049,s34727427,34727427,네이처헤어 상봉점,27,1,3,31
1050,s36096949,36096949,아이벨르팜므 강서힐스테이트점,26,1,4,31
1051,s38218833,38218833,MUCIE,18,2,11,31
1052,s1858315933,1858315933,룩스,26,1,4,31
1053,s1203627879,1203627879,리츠앤라피네,24,3,3,30
1054,s33158246,33158246,팜므제이,19,1,10,30
1055,s11578424,11578424,SM프로헤어 본점,19,1,10,30
1056,s1053657614,1053657614,티지헤어 스페이스세종대점,26,1,3,30
1057,s38647914,38647914,바이감동,22,1,7,30
1058,s1220822567,1220822567,현정헤어,18,1,11,30
1059,s1331069156,1331069156,엠투헤어,22,1,7,30
1060,s13566300,13566300,포레스타 청담본점,18,1,11,30
1061,s38624095,38624095,탑스타일,14,1,15,30
1062,s34761365,34761365,막스헤어뷰 1호점,19,1,10,30
1063,s1433450702,1433450702,오늘헤어,27,1,2,30
1064,s1231129678,1231129678,살롱에스,28,1,1,30
1065,s18605369,18605369,세종헤어 암사롯데점,25,1,4,30
1066,s31126005,31126005,리나앤보스 목동점,19,1,10,30
1067,s1630723650,1630723650,라비앙르로즈 신촌점,27,1,2,30
1068,s1852803929,1852803929,미즈카헤어,18,1,10,29
1069,s1497102530,1497102530,메이블랑 헤어,18,1,10,29
1070,s37379440,37379440,쟈르다뷰티헤어살롱,21,1,7,29
1071,s37993038,37993038,4D헤어 본점,20,1,8,29
1072,s1988564873,1988564873,아이템헤어,19,1,9,29
1073,s21845046,21845046,컬처앤네이처 청담점,16,1,12,29
1074,s36424529,36424529,엘레아노헤어,25,1,3,29
1075,s1200909406,1200909406,엘리바스헤어,21,1,7,29
1076,s1131822800,1131822800,mono line,21,1,7,29
1077,s37942019,37942019,빌라드블랑,17,1,11,29
1078,s20139859,20139859,아이벨르 목동점,26,1,2,29
1079,s37275140,37275140,리소헤어 노원점,18,1,10,29
1080,s1826941226,1826941226,이철헤어커커 구일역점,26,1,1,28
1081,s842792737,842792737,바바헤어,25,1,2,28
1082,s1562909447,1562909447,하놀,17,1,10,28
1083,s1960178806,1960178806,브러쉬05,23,1,4,28
1084,s37927866,37927866,헤어살롱 이수,20,1,7,28
1085,s37101373,37101373,권홍헤어 사가정,21,1,6,28
1086,s37171725,37171725,프롬에스헤어,26,1,1,28
1087,s38703835,38703835,라본헤어 천호점,17,1,10,28
1088,s1478801890,1478801890,리엘헤어,24,1,3,28
1089,s1792724980,1792724980,오다헤어 장지역점,24,1,3,28
1090,s1308251567,1308251567,살롱아더뷰,24,1,3,28
1091,s1767609827,1767609827,헤어 감동 그자체,26,1,1,28
1092,s1155899591,1155899591,보그헤어 왕십리뉴타운점,23,1,4,28
1093,s37495092,37495092,지노헤어 공릉점,24,1,3,28
1094,s1276190871,1276190871,커틸다헤어살롱 마곡점,20,1,7,28
1095,s38482350,38482350,더수컷,17,1,10,28
1096,s1987485082,1987485082,오다헤어 이수점,20,1,7,28
1097,s19971847,19971847,미랑컬헤어 개봉2동점,26,1,1,28
1098,s19718101,19718101,쟈끄데상쥬 강남역점,17,1,10,28
1099,s38693203,38693203,헤어스테이,26,1,1,28
1100,s1254646233,1254646233,준오헤어 마곡역점,24,2,2,28
1101,s56787129,56787129,살롱드키코 방배출발점,17,1,10,28
1102,s944195741,944195741,제오헤어 미아사거리역점,18,1,9,28
1103,s1524922967,1524922967,지노헤어 상봉점,19,2,7,28
1104,s1944237651,1944237651,더룸헤어,24,1,3,28
1105,s31978136,31978136,리챠드프로헤어 신논현역점,16,1,10,27
1106,s1595454551,1595454551,달로아헤어,19,1,7,27
1107,s137346361,137346361,현 헤어아트,16,1,10,27
1108,s35201846,35201846,네이처헤어 수락1호점,20,2,5,27
1109,s1171395161,1171395161,메이킹톤,22,1,4,27
1110,s37049759,37049759,조성기헤어샵,16,1,10,27
1111,s1461032459,1461032459,라온뷰티하우스,22,1,4,27
1112,s1337046569,1337046569,어반그라운드헤어 방이역점,22,1,4,27
1113,s34542323,34542323,리안헤어 목동점,25,1,1,27
1114,s38018743,38018743,리안헤어 중곡점,25,1,1,27
1115,s1794358671,1794358671,무이드,16,1,10,27
1116,s1319083373,1319083373,문살롱헤어,22,1,4,27
1117,s38304904,38304904,테일러테일러 헤어살롱,16,1,10,27
1118,s32625923,32625923,보떼헤어,16,1,10,27
1119,s1102750037,1102750037,브로스헤어,16,1,10,27
1120,s1621573096,1621573096,은은한,24,1,2,27
1121,s19381848,19381848,고아라헤어케어 1호점,22,1,4,27
1122,s977995737,977995737,벨르아미,19,1,7,27
1123,s38320513,38320513,살롱드비,16,1,10,27
1124,s37604654,37604654,제이제이헤어,18,1,8,27
1125,s1478154922,1478154922,아이앤투헤어 이촌럭셔리언트점,25,1,1,27
1126,s20268411,20268411,샵스테이,21,1,4,26
1127,s36246577,36246577,인트라다by한지오 홍대메세나점,15,1,10,26
1128,s18467630,18467630,쥬베 프리제헤어,21,1,4,26
1129,s412559999,412559999,에스컨셉헤어,22,1,3,26
1130,s36473237,36473237,헤어템,15,1,10,26
1131,s1201471957,1201471957,리안헤어 동대문점,19,5,2,26
1132,s38345647,38345647,헤어아티스트M 연희점,20,1,5,26
1133,s31667125,31667125,리안헤어 수락산역점,20,1,5,26
1134,s37288316,37288316,모스트헤어,16,1,9,26
1135,s1863656596,1863656596,더예뻐지는날,17,1,8,26
1136,s1144851187,1144851187,그림 홈,15,1,10,26
1137,s37521860,37521860,몽키헤어,22,1,3,26
1138,s62168773,62168773,오렌지헤어 방화점,15,1,10,26
1139,s1716396686,1716396686,앤썸,24,1,1,26
1140,s1390444523,1390444523,어반레스트,18,1,7,26
1141,s34389029,34389029,이준헤어밸리,24,1,1,26
1142,s31515029,31515029,인트라다by한지오 청담점,15,1,10,26
1143,s38274322,38274322,샾머무르다,15,1,10,26
1144,s70642438,70642438,리소헤어 왕십리점,23,1,2,26
1145,s1674472957,1674472957,ABC헤어 숙대점,24,1,1,26
1146,s708078444,708078444,노이뷰티,15,1,10,26
1147,s1981685634,1981685634,감성을설계하는중연,24,1,1,26
1148,s36166896,36166896,다시봄헤어,15,1,10,26
1149,s1146111678,1146111678,미용실수잔,22,1,3,26
1150,s1482770579,1482770579,아이드블랑 홍제역점,23,1,1,25
1151,s1405773306,1405773306,맨즈살롱,19,1,5,25
1152,s1252944245,1252944245,문헤어 본점,14,1,10,25
1153,s1798906778,1798906778,머리 예쁘다,19,1,5,25
1154,s1383418615,1383418615,리안헤어 홍제역점,21,1,3,25
1155,s1701102071,1701102071,엔투라지바버샵 압구정로데오점,15,1,9,25
1156,s942719166,942719166,아이앤투헤어 이촌리버뷰점,23,1,1,25
1157,s1235489237,1235489237,타미헤어,22,1,2,25
1158,s32481058,32481058,에버마리 헤어,23,1,1,25
1159,s1112185222,1112185222,4D헤어 구로1호점,23,1,1,25
1160,s32072191,32072191,릴리프헤어,14,1,10,25
1161,s1042871452,1042871452,쉼표헤어,23,1,1,25
1162,s37274447,37274447,네이처헤어 수락2호점,22,1,2,25
1163,s1905474851,1905474851,라끌레르헤어,14,1,10,25
1164,s1821485363,1821485363,그샵,14,1,10,25
1165,s1559285649,1559285649,아이레헤어 엔 헤드스파,14,1,10,25
1166,s37687914,37687914,헤어데이즈,14,1,10,25
1167,s13445245,13445245,장루이다비드 장지역점,14,1,10,25
1168,s1229769849,1229769849,최가을헤어드레서 신대방삼거리역점,23,1,1,25
1169,s1171182572,1171182572,이경민포레 반포점,22,1,2,25
1170,s1242582067,1242582067,헤어스튜디오 백가,18,1,6,25
1171,s37008787,37008787,리안헤어 장승배기역점,23,1,1,25
1172,s1467358174,1467358174,YONI,23,1,1,25
1173,s36262967,36262967,초이앤고,14,1,10,25
1174,s1914895024,1914895024,아가페헤어살롱,20,1,4,25
1175,s18076136,18076136,포이에마부띠끄,9,1,15,25
1176,s1379580107,1379580107,이정연헤어살롱,18,1,6,25
1177,s1828182961,1828182961,서연디자인,16,1,8,25
1178,s19861667,19861667,모즈헤어 서교2호점,19,1,5,25
1179,s1704473821,1704473821,디자인하우스 고유HAIR,17,1,7,25
1180,s1954784144,1954784144,에이치무드헤어,22,1,1,24
1181,s1039248237,1039248237,토니앤가이 동부이촌점,13,1,10,24
1182,s34087051,34087051,코드헤어,14,2,8,24
1183,s31519242,31519242,지노헤어 숙대1호점,17,1,6,24
1184,s1193564062,1193564062,IN HAIR,21,1,2,24
1185,s582927503,582927503,칼라스파 본점,20,1,3,24
1186,s1558697651,1558697651,컴온헤어,13,1,10,24
1187,s1482410387,1482410387,헤세드헤어,19,1,4,24
1188,s1836588542,1836588542,살롱어스,17,1,6,24
1189,s507722238,507722238,리에르,13,1,10,24
1190,s1811140596,1811140596,샤인수헤어,21,1,2,24
1191,s32333408,32333408,러블리하우스헤어 방배점,13,1,10,24
1192,s37746836,37746836,커틸다헤어살롱 왕십리점,13,1,10,24
1193,s1700137351,1700137351,디아르떼보스헤어 목동사거리점,21,1,2,24
1194,s1131800410,1131800410,디탐헤어 강남2호점,16,1,7,24
1195,s36827565,36827565,진우헤어 홍대점,17,1,6,24
1196,s37747219,37747219,스테이나인,16,1,7,24
1197,s71377868,71377868,온헤어 by kimmin 2호점,19,1,4,24
1198,s34565659,34565659,아낭재,14,1,9,24
1199,s34363008,34363008,아이디헤어 롯데백화점 청량리점,12,1,10,23
1200,s1480075654,1480075654,봄헤어,20,1,2,23
1201,s13502723,13502723,SM프로헤어 한국외대점,11,1,11,23
1202,s1825535825,1825535825,수아라헤어 성신여대점,19,1,3,23
1203,s1512660663,1512660663,온헤어,21,1,1,23
1204,s200190536,200190536,보에노 헤어,18,1,4,23
1205,s1235887318,1235887318,어뮤즈바이,19,1,3,23
1206,s37903607,37903607,엘본헤어하우스,12,1,10,23
1207,s34786519,34786519,앤즈헤어,12,1,10,23
1208,s1513007561,1513007561,홍대샵,11,2,10,23
1209,s1718538119,1718538119,라피오리레헤어 동묘역점,12,1,10,23
1210,s20391627,20391627,누메아헤어,16,1,6,23
1211,s1628234070,1628234070,헤어로그정,18,1,4,23
1212,s13150121,13150121,더에이치에스헤어,9,3,11,23
1213,s1369954411,1369954411,뷰티룸JJHair,12,1,10,23
1214,s37838106,37838106,주아헤어,21,1,1,23
1215,s36262817,36262817,연희살롱,11,1,11,23
1216,s1483519576,1483519576,더모아,21,1,1,23
1217,s1071253626,1071253626,예뻐요그머리,17,1,5,23
1218,s1721674370,1721674370,GURU HAIR,21,1,1,23
1219,s20636944,20636944,H STYLE헤어살롱 둔촌점,19,1,3,23
1220,s1464188815,1464188815,진우헤어 신촌점,12,1,10,23
1221,s11567686,11567686,자쓰리헤어 구산점,13,1,8,22
1222,s1861683207,1861683207,제오헤어 연신내점,16,1,5,22
1223,s1274269515,1274269515,버튼비헤어,13,1,8,22
1224,s19717991,19717991,아이벨르팜므 목동점,15,1,6,22
1225,s1344523823,1344523823,상봉동미용실,20,1,1,22
1226,s35150614,35150614,코코헤어,17,1,4,22
1227,s1272684228,1272684228,살롱누보,18,1,3,22
1228,s1698538532,1698538532,오다살롱 한남점,17,1,4,22
1229,s1691244759,1691244759,봄헤어살롱3호점,17,1,4,22
1230,s1706438685,1706438685,유얼아이헤어,20,1,1,22
1231,s1765910148,1765910148,디자인헤어,20,1,1,22
1232,s1616158263,1616158263,쉐르헤어,17,1,4,22
1233,s32349843,32349843,쟈끄데상쥬 옥수점,19,1,2,22
1234,s1069710798,1069710798,고운시절,8,1,13,22
1235,s1320628455,1320628455,더 고운헤어,17,1,4,22
1236,s11839856,11839856,제이앤에스헤어,20,1,1,22
1237,s37915994,37915994,스크린헤어살롱 가양역,14,1,7,22
1238,s37573427,37573427,윤스헤어,10,2,10,22
1239,s34919136,34919136,살롱드엘,11,1,10,22
1240,s36620291,36620291,비엠헤어다이스 5호점,11,1,10,22
1241,s11594334,11594334,자쓰리헤어 이대본점,11,1,10,22
1242,s20604291,20604291,사틴헤어 잠실리센츠점,16,1,4,21
1243,s1356638071,1356638071,마리살롱,19,1,1,21
1244,s33252006,33252006,유진헤어,10,1,10,21
1245,s34425338,34425338,헤어샵오엠지,9,1,11,21
1246,s13537019,13537019,루루헤어,10,1,10,21
1247,s477837483,477837483,우홍헤어,10,1,10,21
1248,s1967475571,1967475571,네이처헤어 이수역점,19,1,1,21
1249,s19707657,19707657,쟈끄데상쥬 이대점,13,1,7,21
1250,s1038642236,1038642236,리안헤어 양평역점,16,1,4,21
1251,s1712482354,1712482354,헤어1380 관악농협점,17,1,3,21
1252,s38019625,38019625,엘시헤어,12,1,8,21
1253,s992161916,992161916,우혜림헤어스퀘어 본점,10,1,10,21
1254,s1408234728,1408234728,풀앤드바이뷰티,18,1,2,21
1255,s1639528872,1639528872,헤어망고 대림점,16,1,4,21
1256,s36342659,36342659,수성헤어,9,1,11,21
1257,s1957904212,1957904212,디자이너스 레시피,18,1,2,21
1258,s1892646762,1892646762,라피오리레헤어 약수역점,10,1,10,21
1259,s1458661953,1458661953,파란가위헤어,19,1,1,21
1260,s1920288697,1920288697,TOMOTOMOHAIR,19,1,1,21
1261,s1392888154,1392888154,정성 뷰티라이프 헤어살롱,13,1,7,21
1262,s11829229,11829229,헤어바이반룬하우트 연신내점,17,1,3,21
1263,s1205825548,1205825548,낭만헤어,19,1,1,21
1264,s36528704,36528704,지노헤어 난곡점,13,1,7,21
1265,s1878937885,1878937885,마드헤어살롱,14,1,5,20
1266,s315063746,315063746,지노헤어 개봉역점,17,1,2,20
1267,s1519999365,1519999365,프로젝트라빠헤어 구로디지털단지점,18,1,1,20
1268,s397230526,397230526,커트맨,18,1,1,20
1269,s1299578007,1299578007,머리에반하다,16,1,3,20
1270,s1223736244,1223736244,아망뜨헤어,11,1,8,20
1271,s1398248284,1398248284,Hair319,15,1,4,20
1272,s1596945310,1596945310,아름다울 휘 헤어,13,1,6,20
1273,s1207967652,1207967652,고운헤어,9,1,10,20
1274,s30999798,30999798,이철헤어커커 서교점,12,1,7,20
1275,s1851624520,1851624520,업타운바버샵,16,1,3,20
1276,s1320144905,1320144905,소울살롱,12,1,7,20
1277,s35413240,35413240,문헤어 이마트점,13,1,6,20
1278,s1797809882,1797809882,도쿄헤어,16,1,3,20
1279,s20590447,20590447,비엠헤어다이스 1호점,9,1,10,20
1280,s637563918,637563918,더헤어샵,9,1,10,20
1281,s37818441,37818441,에이치스타일 가로수길,8,1,11,20
1282,s1568306027,1568306027,계서은제이르헤어,13,1,6,20
1283,s1633139936,1633139936,리안헤어 마곡나루점,9,1,10,20
1284,s1926924671,1926924671,플랜에이치 연신내점,17,1,2,20
1285,s1691906820,1691906820,라떼르헤어,18,1,1,20
1286,s1494664002,1494664002,모두다헤어살롱 서울대입구점,18,1,1,20
1287,s37420241,37420241,애드미헤어,18,1,1,20
1288,s1046694528,1046694528,스타일폭스헤어,18,1,1,20
1289,s37521088,37521088,모로헤어,15,1,4,20
1290,s1022889831,1022889831,토브헤어,14,1,5,20
1291,s32435824,32435824,김주아헤어,18,1,1,20
1292,s1440214876,1440214876,어썸헤어,17,1,1,19
1293,s1521289387,1521289387,로드앤미,8,1,10,19
1294,s1586835424,1586835424,LK헤어스튜디오,10,1,8,19
1295,s1457591907,1457591907,꽃자리헤어,12,1,6,19
1296,s1477143614,1477143614,어반그라운드헤어 용산점,13,1,5,19
1297,s1868299946,1868299946,리바이브 헤어살롱,15,1,3,19
1298,s13350347,13350347,서샵,8,1,10,19
1299,s1279881071,1279881071,나눌헤어 노량진점,17,1,1,19
1300,s1215960725,1215960725,리안헤어 성수역점,10,1,8,19
1301,s1942853156,1942853156,커틸다헤어살롱 건대점,12,1,6,19
1302,s36666033,36666033,이철헤어커커 경희대점,15,1,3,19
1303,s1632705336,1632705336,살롱드달리함,10,1,8,19
1304,s34856931,34856931,박승철헤어스투디오 영등포홈플러스점,16,1,2,19
1305,s12828215,12828215,스타일봄헤어살롱 1호점,8,1,10,19
1306,s19866765,19866765,미랑컬헤어 영등포구청역점,11,1,7,19
1307,s1666274369,1666274369,안나올슨,9,1,9,19
1308,s1114583380,1114583380,아름다운헤어살롱,13,1,5,19
1309,s1338171971,1338171971,커틸다헤어살롱 마포구청역점,8,1,10,19
1310,s649795843,649795843,그린듯She&he hair 가재울점,15,1,3,19
1311,s1185245026,1185245026,미민헤어살롱,17,1,1,19
1312,s34937264,34937264,아이엘 라인 헤어,17,1,1,19
1313,s37433105,37433105,MY DESIGNER HAIRSHOP,17,1,1,19
1314,s1009654192,1009654192,오늘헤어,17,1,1,19
1315,s1323642385,1323642385,희쁨헤어,14,1,4,19
1316,s1762099308,1762099308,폴인헤어,17,1,1,19
1317,s1461289744,1461289744,로이드밤 개봉역점,17,1,1,19
1318,s1017426813,1017426813,쎄임,17,1,1,19
1319,s1236523751,1236523751,비아체헤어 수유점,17,1,1,19
1320,s1280736796,1280736796,리안헤어 2001아울렛 구로점,17,1,1,19
1321,s20336676,20336676,모네헤어,8,1,10,19
1322,s1105891144,1105891144,라브리지헤어살롱 발산역점,17,1,1,19
1323,s1083409067,1083409067,르보헤어,17,1,1,19
1324,s900298910,900298910,헤어스타일리스트 이엘,17,1,1,19
1325,s1094288961,1094288961,세라비미용실,12,1,6,19
1326,s113606462,113606462,문헤어 하늘점,8,1,10,19
1327,s37658968,37658968,엔칸토 헤어살롱,9,1,9,19
1328,s1192353547,1192353547,헤어살롱오브 중화역점,15,1,3,19
1329,s1845398037,1845398037,초이진헤어,16,1,2,19
1330,s857799439,857799439,수수살롱,8,1,10,19
1331,s37755029,37755029,살롱바이민,11,1,7,19
1332,s38674090,38674090,크림헤어,8,1,10,19
1333,s31694689,31694689,엘페라,7,1,11,19
1334,s20928901,20928901,아띠제 헤어 살롱,16,1,1,18
1335,s36561390,36561390,레이스토리,9,1,8,18
1336,s37992989,37992989,스카이헤어,16,1,1,18
1337,s1321604487,1321604487,더헤어샵,7,1,10,18
1338,s11729390,11729390,이가자헤어비스 홍대점,13,1,4,18
1339,s817751259,817751259,은채헤어뷰,7,1,10,18
1340,s1058468585,1058468585,hairsalon S샵,14,1,3,18
1341,s1565718986,1565718986,프라이빗수정헤어,10,1,7,18
1342,s11636317,11636317,리안헤어 대림역점,14,1,3,18
1343,s1571100248,1571100248,루이민헤어,16,1,1,18
1344,s1942995419,1942995419,헤어온 서울대병원점,12,3,3,18
1345,s1697149877,1697149877,메종드마샬 마포애오개역점,16,1,1,18
1346,s1776954829,1776954829,어썸헤어,14,1,3,18
1347,s37997771,37997771,청춘미장,9,1,8,18
1348,s1249920275,1249920275,살롱드비쥬,7,1,10,18
1349,s1361026169,1361026169,어반오아시스,15,1,2,18
1350,s19861703,19861703,보뜨마샬헤어살롱,9,1,8,18
1351,s1562158826,1562158826,오프마이원,16,1,1,18
1352,s32637161,32637161,헤어큐브,7,1,10,18
1353,s1170966450,1170966450,보그헤어 가산w몰점,15,1,2,18
1354,s1921426947,1921426947,미아벨라헤어살롱,12,1,5,18
1355,s44931519,44931519,시크릿헤어&노는네일살롱,7,1,10,18
1356,s37057319,37057319,고바이,7,1,10,18
1357,s1353712147,1353712147,소감,8,1,9,18
1358,s37903600,37903600,애이수뷰티,10,1,7,18
1359,s31125133,31125133,주빈헤어,7,1,10,18
1360,s36448701,36448701,이노헤어,15,1,2,18
1361,s1254973932,1254973932,플랜에이치헤어 응암점,15,2,1,18
1362,s1552734993,1552734993,섬려하다,15,1,2,18
1363,s1745174783,1745174783,리안헤어 신도림미래초교점,16,1,1,18
1364,s1424069125,1424069125,살롱드감성,15,1,2,18
1365,s34321710,34321710,비엘헤어,16,1,1,18
1366,s1410619821,1410619821,늘봄by해영,13,1,4,18
1367,s13102452,13102452,쎄봉,12,1,5,18
1368,s335795790,335795790,도시남자,16,1,1,18
1369,s37002601,37002601,우연히행복해지다 프리미엄 본점,7,1,10,18
1370,s1186145196,1186145196,오르헤어,16,1,1,18
1371,s21547290,21547290,라뷰티코아 청담 세이엇데이점,6,1,11,18
1372,s13499981,13499981,벨루스헤어,5,1,11,17
1373,s1977194950,1977194950,살롱드헤어나,9,1,7,17
1374,s1693935150,1693935150,라본헤어 영등포점,7,1,9,17
1375,s1807075223,1807075223,인헤어,10,1,6,17
1376,s1973948815,1973948815,마이오헤어,10,2,5,17
1377,s12948136,12948136,헤어닥터스,1,1,15,17
1378,s37537962,37537962,지노헤어 중앙대점,11,1,5,17
1379,s21710622,21710622,헤어A1924,1,1,15,17
1380,s1260023919,1260023919,M&H헤어연구소,13,1,3,17
1381,s1439536188,1439536188,훈헤어,15,1,1,17
1382,s1982165675,1982165675,토리헤어 송파역점,14,2,1,17
1383,s1871267241,1871267241,We헤어,12,1,4,17
1384,s35262007,35262007,살롱드프롬 노원점,5,1,11,17
1385,s1397254259,1397254259,젠틀웨이브,6,1,10,17
1386,s1985398534,1985398534,헤어다이스 10호점,15,1,1,17
1387,s1119568333,1119568333,서아Queen헤어,6,1,10,17
1388,s18671780,18671780,엘빈헤어,15,1,1,17
1389,s1072746240,1072746240,살롱드밍,6,1,10,17
1390,s37933150,37933150,이마주,15,1,1,17
1391,s13355192,13355192,에이블청담,5,1,11,17
1392,s1185779633,1185779633,벨르헤어,9,1,7,17
1393,s1190115737,1190115737,헤어아티스트M 양평역점,15,1,1,17
1394,s1278320030,1278320030,블랑로젤,15,1,1,17
1395,s20247231,20247231,힐링붙임머리성신여대점,1,1,15,17
1396,s1976619510,1976619510,지엔에이치 헤어,7,1,9,17
1397,s31212768,31212768,하미스토리,1,1,15,17
1398,s1529843124,1529843124,지아헤어 뷰티살롱,15,1,1,17
1399,s18560036,18560036,헤렌헤어,1,1,15,17
1400,s1971799397,1971799397,sole H,13,1,3,17
1401,s1079238984,1079238984,보그헤어 오목교점,12,1,4,17
1402,s1294522198,1294522198,라비살롱,13,1,3,17
1403,s37260342,37260342,디어헤어,9,1,7,17
1404,s1359643476,1359643476,헤어살롱남기다,15,1,1,17
1405,s37297262,37297262,세종헤어 천호점,6,1,10,17
1406,s32581818,32581818,비아이티살롱 목동점,7,1,9,17
1407,s34897494,34897494,바이진 2호점,12,1,4,17
1408,s874387309,874387309,디자이너 혜진,10,1,6,17
1409,s34014035,34014035,상상모리뷰티살롱,5,1,10,16
1410,s1561522440,1561522440,몬트헤어살롱,12,1,3,16
1411,s1429203465,1429203465,살롱드한프로,7,1,8,16
1412,s1345914840,1345914840,헤어바이나니샵,5,1,10,16
1413,s1295136862,1295136862,살롱두와,12,1,3,16
1414,s574319657,574319657,마리뜨헤어,5,1,10,16
1415,s13456967,13456967,헤어아트홀,4,1,11,16
1416,s1298360966,1298360966,살롱드헤어,14,1,1,16
1417,s1821834988,1821834988,살롱 드 라온,5,1,10,16
1418,s1209354127,1209354127,가람헤어,14,1,1,16
1419,s33571737,33571737,모즈헤어 응암점,14,1,1,16
1420,s1123549671,1123549671,봉헤어,11,1,4,16
1421,s1378433480,1378433480,헤어바이탄,8,1,7,16
1422,s13527222,13527222,살롱드프롬 송파위례,4,1,11,16
1423,s77696576,77696576,나만의공간,14,1,1,16
1424,s34721905,34721905,아벨헤어,7,1,8,16
1425,s1950521506,1950521506,살롱드마이미,12,1,3,16
1426,s79128068,79128068,르빠마 미용실,7,1,8,16
1427,s1140703493,1140703493,모코헤어살롱,13,1,2,16
1428,s70127962,70127962,어느멋진날 헤어,13,1,2,16
1429,s1893500755,1893500755,권은숙헤어샵,12,1,3,16
1430,s1245328027,1245328027,이비헤어,14,1,1,16
1431,s37162669,37162669,리안헤어 불광점,14,1,1,16
1432,s35476411,35476411,로얄살롱,5,1,10,16
1433,s31704709,31704709,라비드헤어,11,1,4,16
1434,s36684493,36684493,호시헤어,5,1,10,16
1435,s1619188356,1619188356,살롱드미엘,5,1,10,16
1436,s1225286372,1225286372,오직 헤어살롱,8,1,7,16
1437,s1257885933,1257885933,옥이네 미장원,14,1,1,16
1438,s1355363665,1355363665,주헤어샵,14,1,1,16
1439,s1336480033,1336480033,라엘헤어필,13,1,2,16
1440,s13399240,13399240,토니앤가이 청담본점,2,1,13,16
1441,s36523927,36523927,박승철헤어스투디오 중계홈플러스점,12,1,3,16
1442,s1660980571,1660980571,힐끗헤어,8,1,7,16
1443,s251300977,251300977,몽띠쁘뷰티,6,1,9,16
1444,s1675605911,1675605911,연헤어,12,1,3,16
1445,s1001051047,1001051047,바바헤어 암사역점,9,1,6,16
1446,s33460971,33460971,뉴크레용헤어,5,1,10,16
1447,s37357451,37357451,머리만지는사람 한성대본점,5,1,10,16
1448,s1007788807,1007788807,XQ Hair,8,7,1,16
1449,s1753305051,1753305051,뉴크레용컬러&케어,14,1,1,16
1450,s36636496,36636496,미누헤어,7,1,8,16
1451,s1719160731,1719160731,티지헤어 살롱 고덕그라시움점,11,1,4,16
1452,s1592528293,1592528293,엠씨헤어,13,1,2,16
1453,s35244174,35244174,커틸다헤어살롱 동대문점,5,1,10,16
1454,s1146677093,1146677093,살롱드퓨어,7,1,8,16
1455,s1214447645,1214447645,살롱드라벨리,13,1,2,16
1456,s1339771976,1339771976,Yo Salon,14,1,1,16
1457,s1284766119,1284766119,반하다헤어살롱,13,1,2,16
1458,s36609964,36609964,뉴엘헤어,12,1,3,16
1459,s1235001067,1235001067,뷰티인헤어,10,1,5,16
1460,s568401350,568401350,살롱드환희,5,1,10,16
1461,s36190723,36190723,헤어파티,11,1,4,16
1462,s1238731833,1238731833,라브리지 목동점,13,1,1,15
1463,s1207505418,1207505418,모드니살롱,13,1,1,15
1464,s1386345686,1386345686,살롱더무드,12,1,2,15
1465,s21407151,21407151,제이살롱 붙임머리,1,1,13,15
1466,s1104866554,1104866554,살롱더희야,9,1,5,15
1467,s1537432649,1537432649,헤어망고 서울대역점,13,1,1,15
1468,s1094454510,1094454510,자스민헤어,13,1,1,15
1469,s36183649,36183649,어반스타일러,9,1,5,15
1470,s36414347,36414347,엘세븐헤어 성신여대점,11,1,3,15
1471,s1153727765,1153727765,다수헤어살롱,10,1,4,15
1472,s21440218,21440218,제오헤어 길동점,12,1,2,15
1473,s1962860934,1962860934,Aile Hair,11,1,3,15
1474,s35958304,35958304,히로헤어살롱,10,1,4,15
1475,s1329700302,1329700302,헤어BS12,13,1,1,15
1476,s13523769,13523769,라푼젤,8,1,6,15
1477,s1968502199,1968502199,더쉐입,9,1,5,15
1478,s13395242,13395242,이훈헤어칼라 화곡점,11,1,3,15
1479,s32514241,32514241,사월의양 방이점,8,1,6,15
1480,s21445387,21445387,바이윰헤어,11,1,3,15
1481,s32423905,32423905,다올헤어,5,1,9,15
1482,s87840549,87840549,제이스타일플로어,8,1,6,15
1483,s1278893966,1278893966,비비드비,13,1,1,15
1484,s1498257788,1498257788,헤어아티스트M 헬리오시티송파점,8,1,6,15
1485,s20607725,20607725,이철헤어커커 행당점,11,1,3,15
1486,s1112567324,1112567324,프롬제이헤어살롱,9,1,5,15
1487,s1719267846,1719267846,리안헤어 신당점,12,1,2,15
1488,s1055279857,1055279857,차니헤어,11,1,3,15
1489,s13072708,13072708,레트로나인,3,1,11,15
1490,s37890643,37890643,미랑컬헤어 오류동점,10,1,4,15
1491,s35075787,35075787,아이벨르팜므 강동점,12,1,2,15
1492,s1964612342,1964612342,헤어두,12,1,2,15
1493,s1884110761,1884110761,이음,11,1,3,15
1494,s11547390,11547390,지모헤어 홍대점,1,1,13,15
1495,s597852139,597852139,어헤즈맨,1,4,10,15
1496,s1479860620,1479860620,지노헤어 성균관대점,13,1,1,15
1497,s19480825,19480825,샤미즈,4,1,10,15
1498,s1247449018,1247449018,아띠샵,13,1,1,15
1499,s13301373,13301373,시즌헤어,2,1,11,14
1500,s1098490319,1098490319,살롱드제니,8,1,5,14
1501,s47097183,47097183,박승철헤어스투디오 위례신도시점,9,1,4,14
1502,s13355189,13355189,에스휴,2,1,11,14
1503,s1069564812,1069564812,아이벨르팜므 고덕그라시움점,11,1,2,14
1504,s1112759277,1112759277,바니스헤어,12,1,1,14
1505,s21576011,21576011,데이스토리헤어,12,1,1,14
1506,s20907637,20907637,압구정헤어,12,1,1,14
1507,s1600417446,1600417446,모나미헤어,9,1,4,14
1508,s1498674929,1498674929,헤어팔레트,3,1,10,14
1509,s36620553,36620553,신림붙임머리 조조헤어,3,1,10,14
1510,s1297374480,1297374480,미담헤어,3,1,10,14
1511,s21331646,21331646,아톰헤어 성북구청점,12,1,1,14
1512,s13151045,13151045,월드헤어,3,1,10,14
1513,s20880589,20880589,헤어바이태헌,12,1,1,14
1514,s1991459512,1991459512,맨드살롱,1,7,6,14
1515,s651428447,651428447,살롱제이,12,1,1,14
1516,s1078481721,1078481721,그 미장원,11,1,2,14
1517,s37577220,37577220,라움헤어,2,1,11,14
1518,s36932760,36932760,지노헤어 동덕여대점,10,1,3,14
1519,s1021017529,1021017529,디블링헤어살롱,12,1,1,14
1520,s1953387663,1953387663,ABC헤어,11,2,1,14
1521,s1076831000,1076831000,지노헤어 목동점,10,1,3,14
1522,s18360714,18360714,쁘띠뜨헤어,3,1,10,14
1523,s1944190213,1944190213,플랜에이치 개봉점,12,1,1,14
1524,s31009756,31009756,퍼니헤어 홍대본점,1,1,12,14
1525,s1555363178,1555363178,W헤어,12,1,1,14
1526,s30976015,30976015,미니샵,1,1,12,14
1527,s38009680,38009680,사틴헤어 대치도곡점,1,1,12,14
1528,s1037820293,1037820293,아토,12,1,1,14
1529,s1294705939,1294705939,아이드블랑 연신내역점,12,1,1,14
1530,s20336100,20336100,헤어아떼 신월점,12,1,1,14
1531,s1216276464,1216276464,딘컴헤어,12,1,1,14
1532,s1031519222,1031519222,크리드헤어,12,1,1,14
1533,s1904486164,1904486164,판다헤어,4,1,9,14
1534,s1631776320,1631776320,하이텐션바버샵,3,1,10,14
1535,s1495141858,1495141858,살롱드엘로,12,1,1,14
1536,s12836462,12836462,이지연더스타일,3,1,10,14
1537,s37822278,37822278,해어화미용실,12,1,1,14
1538,s35346568,35346568,헤어바이수,5,1,8,14
1539,s1294145187,1294145187,라온헤어살롱,12,1,1,14
1540,s13155267,13155267,까피오헤어,1,4,9,14
1541,s1040867392,1040867392,르미르헤어,12,1,1,14
1542,s1257948890,1257948890,프로젝트라빠헤어 신촌점,12,1,1,14
1543,s1460565487,1460565487,난드리헤어샵,7,1,6,14
1544,s1529892767,1529892767,와이헤어,10,1,3,14
1545,s34479153,34479153,오리날다 헤어&뷰티,8,1,5,14
1546,s1384057146,1384057146,크레스크헤어,12,1,1,14
1547,s34689422,34689422,서희헤어,5,1,8,14
1548,s1502911729,1502911729,차츰,10,1,3,14
1549,s38279759,38279759,루카스헤어,9,1,4,14
1550,s38645632,38645632,살롱에이 성신여대점,12,1,1,14
1551,s36324450,36324450,H STYLE헤어살롱 장위점,8,1,5,14
1552,s36957660,36957660,리안헤어 시흥점,12,1,1,14
1553,s1394530777,1394530777,더아라헤어,12,1,1,14
1554,s1162694866,1162694866,에스뷰테라 대치역점,10,1,3,14
1555,s36823824,36823824,제오헤어 신천역점,6,1,7,14
1556,s1744082861,1744082861,살롱드760,10,1,2,13
1557,s836930365,836930365,아뜰리에제이 헤어살롱,2,1,10,13
1558,s1248929231,1248929231,엔투헤어,10,1,2,13
1559,s1946316258,1946316258,로이드밤 금천구청역점,11,1,1,13
1560,s1118925545,1118925545,김송정머리터,2,1,10,13
1561,s1680106125,1680106125,살롱드빈,11,1,1,13
1562,s1956027859,1956027859,플랜에이치 은평진관점,11,1,1,13
1563,s764155343,764155343,헤어루아르,1,1,11,13
1564,s405803523,405803523,르포렘헤어,9,1,3,13
1565,s1845507449,1845507449,살롱드오캄,11,1,1,13
1566,s13304563,13304563,아리스헤어,1,1,11,13
1567,s31098876,31098876,슈가헤어 방배점,1,1,11,13
1568,s32448818,32448818,6번가 헤어살롱,10,1,2,13
1569,s21268890,21268890,신오키새날,1,1,11,13
1570,s19977990,19977990,훈헤어,9,1,3,13
1571,s1251403161,1251403161,헤어파체,11,1,1,13
1572,s1001053455,1001053455,라헤어,6,1,6,13
1573,s37289164,37289164,부헤스 살롱,4,1,8,13
1574,s33595528,33595528,쌤시크,1,1,11,13
1575,s1145036440,1145036440,살롱드80,10,1,2,13
1576,s1408340305,1408340305,살롱리아,1,1,11,13
1577,s95575426,95575426,콜라보엑스,1,1,11,13
1578,s37202351,37202351,김활란뮤제네프 청담부티끄점,1,1,11,13
1579,s36652386,36652386,로앤로우,1,1,11,13
1580,s13166737,13166737,보이드바이박철,1,1,11,13
1581,s11831176,11831176,이경민포레 청담본점,1,1,11,13
1582,s32323342,32323342,프리티붙임머리,1,1,11,13
1583,s1521604146,1521604146,라오나제,4,1,8,13
1584,s11561757,11561757,라메종뷰티,1,1,11,13
1585,s1318219435,1318219435,아우라헤어,7,1,5,13
1586,s1818689290,1818689290,김현헤어,7,1,5,13
1587,s1693097558,1693097558,리안헤어 강동역점,11,1,1,13
1588,s37701354,37701354,김성희헤어 신정역점,10,1,2,13
1589,s1062157383,1062157383,라브리지 전농롯데캐슬점,11,1,1,13
1590,s1660789518,1660789518,보그헤어 길음뉴타운점,11,1,1,13
1591,s1552079834,1552079834,마이살롱,11,1,1,13
1592,s1572290096,1572290096,와이영,10,1,2,13
1593,s1090831046,1090831046,킴스헤어,9,1,3,13
1594,s1968679949,1968679949,인샵&붙임머리,2,1,10,13
1595,s1327666753,1327666753,엘크레헤어,10,1,2,13
1596,s98956494,98956494,폼헤어살롱,11,1,1,13
1597,s1373706791,1373706791,루미에르 붙임머리,1,1,11,13
1598,s37653649,37653649,메모리헤어,1,1,11,13
1599,s19851677,19851677,와이스타일,9,1,3,13
1600,s1900836896,1900836896,모아쉬,7,1,5,13
1601,s1159589728,1159589728,더 디자인 차이,9,1,3,13
1602,s1953030921,1953030921,120 에비뉴,1,1,11,13
1603,s35568126,35568126,헤어포인트,1,1,11,13
1604,s13144694,13144694,시바드레드락,1,1,11,13
1605,s31752268,31752268,바닐랄라헤어,1,1,11,13
1606,s582184412,582184412,더헤어 창동점,1,2,10,13
1607,s35483013,35483013,르메이어 헤어,8,1,4,13
1608,s13002512,13002512,파비엔에이치,1,1,11,13
1609,s1963243315,1963243315,살롱드라떼,8,1,4,13
1610,s35263835,35263835,토니앤가이 콘래드호텔점,1,1,11,13
1611,s1753884534,1753884534,24시 레드헤어,3,1,9,13
1612,s21587785,21587785,공간에이트,1,1,11,13
1613,s13151166,13151166,머리쟁이,1,1,11,13
1614,s39989542,39989542,청담동미용실,1,1,11,13
1615,s18495548,18495548,김키키헤어,2,1,10,13
1616,s38269084,38269084,머반헤어,1,1,11,13
1617,s1123447170,1123447170,엘리시아헤어,3,1,9,13
1618,s13355558,13355558,슈어 바이 정민,1,1,11,13
1619,s34120412,34120412,더 제이 헤어메이크업,1,1,11,13
1620,s12453356,12453356,헤어캐슬24시붙임머리전문점 논현지점,1,1,10,12
1621,s34203513,34203513,요닝,1,1,10,12
1622,s1560420460,1560420460,벨로헤어,1,1,10,12
1623,s256545219,256545219,온리유헤어 슈에뜨점,1,1,10,12
1624,s1365614114,1365614114,감동헤어,1,1,10,12
1625,s1922813306,1922813306,제오헤어 이대역점,10,1,1,12
1626,s36792819,36792819,스위트벙커,1,1,10,12
1627,s1093901877,1093901877,스위트벙커 구로2지점,1,1,10,12
1628,s34364048,34364048,마샬뷰티살롱,1,1,10,12
1629,s1736590524,1736590524,스위트벙커 가산3지점,1,1,10,12
1630,s37842539,37842539,아스카다 헤어 디자인,1,1,10,12
1631,s33771424,33771424,헤어살롱나루 노원점,6,1,5,12
1632,s75056372,75056372,트루핏앤힐 바버샵 청담본점,1,1,10,12
1633,s38003493,38003493,밀리터리바버샵,1,1,10,12
1634,s1336972309,1336972309,쇼군헤어포맨 독산본점,9,1,2,12
1635,s1459925692,1459925692,리안헤어 신창점,8,1,3,12
1636,s31371615,31371615,Good Hair,1,1,10,12
1637,s36882839,36882839,엘세븐헤어 내방역점,7,1,4,12
1638,s38779993,38779993,살롱드쉬즈모,1,1,10,12
1639,s184749003,184749003,클라시 헤어,1,1,10,12
1640,s20925314,20925314,신림모리붙임머리,1,1,10,12
1641,s1348916502,1348916502,그리다헤어,1,1,10,12
1642,s35003485,35003485,SAHAIR,1,1,10,12
1643,s36844355,36844355,뷰헤어,1,1,10,12
1644,s1770401780,1770401780,라끄블랑헤어,10,1,1,12
1645,s38648515,38648515,디어리헤어,1,1,10,12
1646,s17950809,17950809,은지헤어크리닉,1,1,10,12
1647,s1069854452,1069854452,What is your colour,1,1,10,12
1648,s91671162,91671162,디자인안,3,1,8,12
1649,s1251425326,1251425326,작은사치헤어살롱,10,1,1,12
1650,s36324485,36324485,이가자헤어비스 남현홈플러스점,8,1,3,12
1651,s36096944,36096944,앤비스토리헤어,1,1,10,12
1652,s1901076450,1901076450,윌리웰리,10,1,1,12
1653,s885261084,885261084,신림붙임머리 아이홍,2,1,9,12
1654,s1149291074,1149291074,엘루아헤어,1,1,10,12
1655,s37864992,37864992,내 멋대로 헤어,1,1,10,12
1656,s1181012099,1181012099,낯꽃피다,1,1,10,12
1657,s1685439795,1685439795,살롱 드 아낌,5,1,6,12
1658,s549195463,549195463,이음머리공작소 압구정점,1,1,10,12
1659,s13150106,13150106,T775붙임머리,1,1,10,12
1660,s1764682649,1764682649,케이헤어,3,1,8,12
1661,s34321135,34321135,세르피에헤어 1호점,1,1,10,12
1662,s30982491,30982491,민스헤어 동묘점,1,1,10,12
1663,s35719820,35719820,리안헤어 관악현대점,10,1,1,12
1664,s11659960,11659960,클레오파트라미용실,1,1,10,12
1665,s1147471370,1147471370,살롱앤드,1,1,10,12
1666,s1190877588,1190877588,The감동 성신여대점,1,1,10,12
1667,s1739320025,1739320025,이솔레코드,1,1,10,12
1668,s1160834537,1160834537,골목,1,1,10,12
1669,s31363401,31363401,감성헤어 서울종암점,1,1,10,12
1670,s34779313,34779313,올드스캣,1,1,10,12
1671,s1479871135,1479871135,이철헤어커커 상도점,8,1,3,12
1672,s37874256,37874256,하이드아웃,1,1,10,12
1673,s33077971,33077971,헤어샵소이,1,1,10,12
1674,s30826216,30826216,제이헤어,1,1,10,12
1675,s38010304,38010304,피가로,1,1,10,12
1676,s31399653,31399653,송헤어샵,1,1,10,12
1677,s36663328,36663328,에이치헤어드레서,1,1,10,12
1678,s18425982,18425982,헤어스케치,1,1,10,12
1679,s35914754,35914754,티티붙임머리,1,1,10,12
1680,s11759130,11759130,라비에벨헤어 이대본점,1,1,10,12
1681,s1338907217,1338907217,가디 헤어샵,8,1,3,12
1682,s38353085,38353085,준헤어,1,1,10,12
1683,s612779336,612779336,아이앤투헤어 보라매점,10,1,1,12
1684,s85377225,85377225,유진헤어페이스,9,1,2,12
1685,s12199708,12199708,도쿄랜드,1,1,10,12
1686,s36435128,36435128,미코헤어,1,1,10,12
1687,s37849369,37849369,문헤어 로즈점,8,1,3,12
1688,s38412410,38412410,헤어드리밍,1,1,10,12
1689,s37484318,37484318,헤어바이화랑,1,1,10,12
1690,s35188120,35188120,KJ 스타일,1,1,10,12
1691,s34329631,34329631,아이벨르팜므 미아뉴타운점,9,1,2,12
1692,s37399684,37399684,이훈ALL30000,8,1,3,12
1693,s34761821,34761821,힐헤어,8,1,3,12
1694,s21012318,21012318,살롱드안나 성신여대캠퍼스점,6,1,5,12
1695,s367360827,367360827,더썸뷰티,1,1,10,12
1696,s1093878052,1093878052,양미장원,9,1,2,12
1697,s32816770,32816770,더샾헤어 망원점,1,1,10,12
1698,s1631764007,1631764007,ADORE HAIR,1,1,10,12
1699,s36768834,36768834,DOHAIR,1,1,10,12
1700,s37889562,37889562,세르피에헤어 2호점,1,1,10,12
1701,s503996819,503996819,시우공감,7,1,4,12
1702,s37769105,37769105,최가을헤어드레서 명지대점,8,2,2,12
1703,s34849610,34849610,모던타임즈헤어,1,1,10,12
1704,s32358933,32358933,M3D쏘타헤어 강남점,1,1,10,12
1705,s36631029,36631029,링고헤어,1,1,10,12
1706,s82227852,82227852,미씨엘로헤어,8,1,3,12
1707,s35657080,35657080,라프레사,6,1,5,12
1708,s1186388090,1186388090,ROOM 201,10,1,1,12
1709,s37932965,37932965,아스카헤어,1,1,10,12
1710,s36298119,36298119,루디아메이크업헤어,1,1,10,12
1711,s1119904358,1119904358,베니티헤어,1,1,10,12
1712,s20939450,20939450,비타민헤어샵,1,1,10,12
1713,s38457337,38457337,보그헤어 강남역점,1,1,10,12
1714,s1596877387,1596877387,네이처헤어 미아2호점,10,1,1,12
1715,s1897099012,1897099012,미미샵,1,1,10,12
1716,s31372005,31372005,홍대붙임머리 크레이지드레드,1,1,10,12
1717,s13516031,13516031,헤어바이반룬하우트 용산점,9,1,2,12
1718,s1712312658,1712312658,라끄라운지헤어,8,1,3,12
1719,s35149795,35149795,살롱드라보떼,10,1,1,12
1720,s13420390,13420390,우선제 헤어루시 목동점,1,1,10,12
1721,s33636200,33636200,리안헤어 방화역점,1,1,10,12
1722,s1621255332,1621255332,카미헤어,1,1,10,12
1723,s38274035,38274035,헤어살롱 봄꽃,5,1,6,12
1724,s32799693,32799693,라이언스타일,1,1,10,12
1725,s505146609,505146609,리파이너리 홍대본점,1,1,10,12
1726,s35076056,35076056,낭만부티크,1,1,10,12
1727,s808354574,808354574,레드앤블루,1,1,10,12
1728,s37696460,37696460,오버마운트,1,1,10,12
1729,s487560366,487560366,마타헤어,2,1,9,12
1730,s37778829,37778829,달콤한게으름 민들레점,1,1,10,12
1731,s19782250,19782250,WHOS,1,1,10,12
1732,s13502987,13502987,쏠헤어,1,1,10,12
1733,s37196999,37196999,소호헤어,10,1,1,12
1734,s167895234,167895234,샵헤어,1,1,10,12
1735,s35905243,35905243,나나베이지,1,1,10,12
1736,s32960029,32960029,정헤어스토리,1,1,10,12
1737,s18511724,18511724,헤어살롱조이,1,1,10,12
1738,s19728909,19728909,하루헤어,1,1,10,12
1739,s38510790,38510790,얼번스트리트,1,1,10,12
1740,s32537739,32537739,마블,1,1,10,12
1741,s1085951346,1085951346,이룸헤어,8,1,3,12
1742,s38705842,38705842,살롱드르망,1,1,10,12
1743,s37072913,37072913,스튜디오모니크,1,1,10,12
1744,s37045926,37045926,A LITTLE BIT,1,1,10,12
1745,s31347100,31347100,신승원컷앤컷 강남점,1,1,10,12
1746,s37098912,37098912,초이스살롱,1,1,10,12
1747,s34007118,34007118,우희살롱,4,1,7,12
1748,s13120486,13120486,아리아헤어,1,1,10,12
1749,s37747224,37747224,스트릿헤어,1,1,10,12
1750,s1103647451,1103647451,헤어스토리,10,1,1,12
1751,s37350451,37350451,H STYLE헤어살롱 강동역점,9,1,2,12
1752,s37829987,37829987,가꿈헤어드림 y스퀘어미아점,1,1,10,12
1753,s37653136,37653136,헤어살롱결,1,1,10,12
1754,s33831186,33831186,원헤어,1,1,10,12
1755,s36924684,36924684,봉봉헤어살롱,1,1,10,12
1756,s34013457,34013457,제이뷰티,1,1,10,12
1757,s1902354339,1902354339,붙이다니,1,1,10,12
1758,s31608356,31608356,세마헤어 명동점,1,1,10,12
1759,s21224623,21224623,어썸헤어 건대본점,1,1,10,12
1760,s1384907291,1384907291,그리고헤어,10,1,1,12
1761,s37700911,37700911,코제트헤어 사가정점,1,1,10,12
1762,s1822817608,1822817608,아르아떼헤어,10,1,1,12
1763,s1913929152,1913929152,HOMEALONE,1,1,10,12
1764,s1574774970,1574774970,결 HAIR SHOP,6,1,5,12
1765,s1606063310,1606063310,엘린헤어,10,1,1,12
1766,s35849023,35849023,아이브로우바 바이이연 홍대점,1,1,10,12
1767,s37873219,37873219,은살롱,1,1,10,12
1768,s32720903,32720903,헤어작 in 약수,1,1,10,12
1769,s36432991,36432991,더설렘헤어,7,1,3,11
1770,s13399566,13399566,레드라인헤어,1,1,9,11
1771,s31607944,31607944,헤어샵오늘,1,1,9,11
1772,s1950593281,1950593281,헤어 살롱 바비리안,9,1,1,11
1773,s1506512491,1506512491,모두다헤어살롱,9,1,1,11
1774,s36170780,36170780,오다헤어 상봉점,6,1,4,11
1775,s36123883,36123883,디토헤어살롱,2,2,7,11
1776,s36481244,36481244,날아 헤어,2,1,8,11
1777,s37309147,37309147,이엔에스,1,1,9,11
1778,s37906792,37906792,디토헤어살롱,5,1,5,11
1779,s32587634,32587634,코랄리헤어 동부이촌점,8,1,2,11
1780,s1847090372,1847090372,문헤어,9,1,1,11
1781,s32537818,32537818,여우짓붙임머리 강남점,1,1,9,11
1782,s1044173807,1044173807,살롱에이투지 헬리오시티점,8,1,2,11
1783,s843044366,843044366,헤어캐슬,2,1,8,11
1784,s36003709,36003709,정샘물인스피레이션 에비뉴엘점,3,1,7,11
1785,s37489284,37489284,오땡큐 공릉점,1,1,9,11
1786,s1319204851,1319204851,인생미장원,9,1,1,11
1787,s18864238,18864238,수헤어,9,1,1,11
1788,s35664076,35664076,리안헤어 송정역점,1,1,9,11
1789,s1640698208,1640698208,HG공간헤어&아뜰리에,1,1,9,11
1790,s1518582095,1518582095,MakeYourHair,9,1,1,11
1791,s34490660,34490660,세종헤어 올림픽프라자점,6,1,4,11
1792,s1391495115,1391495115,리리의커트룸,9,1,1,11
1793,s1627678283,1627678283,프롬에이 공덕점,1,1,9,11
1794,s674627907,674627907,Hair by 가희,9,1,1,11
1795,s33152323,33152323,라헤브헤어,8,1,2,11
1796,s1836104300,1836104300,헤어갤러리 아인,9,1,1,11
1797,s1846740952,1846740952,오늘헤어,8,1,2,11
1798,s1021800324,1021800324,갈현동미용실,9,1,1,11
1799,s1067301402,1067301402,느루헤어,8,1,2,11
1800,s21567885,21567885,베르헤어,1,1,9,11
1801,s32990909,32990909,가미수헤어,1,1,9,11
1802,s1587139412,1587139412,이철헤어커커 개봉역점,8,1,2,11
1803,s1240025552,1240025552,나예헤어 마곡본점,1,1,9,11
1804,s1848631922,1848631922,아우라헤어 마포점,3,1,7,11
1805,s35387372,35387372,체인지이즈굿,1,1,9,11
1806,s37687137,37687137,아도르헤어,1,1,9,11
1807,s37713026,37713026,상상모리뷰티살롱 송파점,1,1,9,11
1808,s1343666701,1343666701,유진미장원,9,1,1,11
1809,s36859785,36859785,헤움,1,1,9,11
1810,s31714693,31714693,헤어작 in 신당,1,1,9,11
1811,s201203996,201203996,신주쿠헤어 송파점,1,1,9,11
1812,s1767752909,1767752909,바이하루 합정점,3,1,7,11
1813,s1673478027,1673478027,골목길미장원,9,1,1,11
1814,s36643411,36643411,피가로스미용실,1,1,9,11
1815,s31197672,31197672,스타일리스트서연,3,1,7,11
1816,s1500974761,1500974761,엠스타일헤어살롱,9,1,1,11
1817,s20624179,20624179,당산헤어스튜디오,1,1,9,11
1818,s1680434437,1680434437,HAIR801,8,1,2,11
1819,s13153235,13153235,랄라팔루자 헤어 건대점,1,2,8,11
1820,s1584625481,1584625481,살롱딜라잇,9,1,1,11
1821,s36917349,36917349,마루헤어,1,1,9,11
1822,s1967934805,1967934805,린 헤어살롱,5,1,5,11
1823,s1252227070,1252227070,백야드헤어하우스,9,1,1,11
1824,s13566368,13566368,미앤희,5,1,5,11
1825,s36836333,36836333,보니또헤어살롱,1,1,9,11
1826,s1036522324,1036522324,머리해봄,8,1,2,11
1827,s1558283245,1558283245,주하헤어,9,1,1,11
1828,s615563676,615563676,STYLIST Y HAIR 노량진점,1,1,9,11
1829,s35357167,35357167,리안헤어 전농사거리점,8,1,2,11
1830,s37747202,37747202,하루,8,1,1,10
1831,s33937748,33937748,살롱데얼스,3,1,6,10
1832,s35965728,35965728,라끄헤어,8,1,1,10
1833,s1380074221,1380074221,살롱 드 루시헤어,2,1,7,10
1834,s1124367993,1124367993,헤어살롱카라,7,1,2,10
1835,s30944151,30944151,뱅헤어 1호점,1,1,8,10
1836,s34616006,34616006,일리아바이예민,1,1,8,10
1837,s1996961139,1996961139,나우헤어,6,1,3,10
1838,s33781185,33781185,힐링헤어,3,1,6,10
1839,s1082296954,1082296954,헤어하우스361,8,1,1,10
1840,s1736021282,1736021282,헤어제이,8,1,1,10
1841,s36663313,36663313,리안헤어 신반포역래미안점,1,1,8,10
1842,s37175738,37175738,다옴샵,1,1,8,10
1843,s528920477,528920477,매티스,4,1,5,10
1844,s1382316855,1382316855,우주헤어,6,1,3,10
1845,s1465971569,1465971569,색갈은짙은갈색,1,1,8,10
1846,s651343066,651343066,Hair봄에,4,1,5,10
1847,s1209964072,1209964072,플랜에이치 건대점,1,1,8,10
1848,s1978347989,1978347989,W에비뉴헤어&네일,8,1,1,10
1849,s37933023,37933023,두미헤어,1,1,8,10
1850,s36905464,36905464,Wythe138,1,1,8,10
1851,s665939516,665939516,박승철헤어스투디오 서초점,6,1,3,10
1852,s11673624,11673624,마지크,1,1,8,10
1853,s31403355,31403355,헤어라운지,1,1,8,10
1854,s13317245,13317245,헤어아떼 문정점,7,1,2,10
1855,s34506018,34506018,바바헤어,1,1,8,10
1856,s37910437,37910437,헤어살롱 메르헨,1,1,8,10
1857,s532424639,532424639,유앤유헤어살롱,1,1,8,10
1858,s37267978,37267978,김호증모 도봉구 체인점,1,1,8,10
1859,s1281659756,1281659756,머리하는공간,8,1,1,10
1860,s13220674,13220674,재클린,1,1,8,10
1861,s1478615206,1478615206,다온헤어,8,1,1,10
1862,s11821251,11821251,명동헤어뱅크,1,1,8,10
1863,s37591843,37591843,살롱비,1,1,8,10
1864,s286798409,286798409,새봄헤어,7,1,2,10
1865,s37049667,37049667,리안헤어 방배카페거리점,6,1,3,10
1866,s37547089,37547089,유민헤어아뜨리에,8,1,1,10
1867,s1191864337,1191864337,도교헤어살롱,8,1,1,10
1868,s34329432,34329432,엘리헤어,1,1,8,10
1869,s1137490534,1137490534,스웨이헤어,8,1,1,10
1870,s37927506,37927506,르보에 헤어살롱,6,1,3,10
1871,s1301106348,1301106348,이엠헤어,8,1,1,10
1872,s1692349360,1692349360,H스타일헤어살롱 당산점,7,1,2,10
1873,s21080618,21080618,비에이헤어,1,1,8,10
1874,s38774543,38774543,엣지있는헤어,1,1,8,10
1875,s1246331459,1246331459,리안헤어 강남세곡점,8,1,1,10
1876,s33141694,33141694,이젤헤어,8,1,1,10
1877,s1817652623,1817652623,빛나게 헤어,6,1,3,10
1878,s43207613,43207613,코코살롱,7,1,2,10
1879,s541472003,541472003,Dk헤어,4,1,5,10
1880,s1318814654,1318814654,맨드살롱 2호점,1,8,1,10
1881,s37271747,37271747,모던헤어,1,1,8,10
1882,s1300337002,1300337002,스타일을탐하다,8,1,1,10
1883,s1021335535,1021335535,아비앙또 헤어,8,1,1,10
1884,s836770372,836770372,라프로비아 헤어살롱,6,1,3,10
1885,s31083494,31083494,헤어디자인모습 서교본점,1,1,8,10
1886,s1330053603,1330053603,하성기헤어살롱,8,1,1,10
1887,s11880276,11880276,라보노헤어 1호점,1,1,8,10
1888,s1826532565,1826532565,헤어스테이션,8,1,1,10
1889,s1767402647,1767402647,푸름헤어,1,1,8,10
1890,s35117755,35117755,라브리지 헤어살롱 자양점,7,1,2,10
1891,s1691892278,1691892278,끌라 헤어,6,1,3,10
1892,s1338342994,1338342994,리파이너리,1,1,8,10
1893,s71516338,71516338,토리헤어 신림점,8,1,1,10
1894,s879799670,879799670,비엠헤어다이스 8호점,8,1,1,10
1895,s1242241030,1242241030,디오라,2,1,7,10
1896,s557025091,557025091,오다헤어 당산역점,8,1,1,10
1897,s1425855148,1425855148,오늘우리헤어,8,1,1,10
1898,s32424037,32424037,살롱드알레,1,1,8,10
1899,s1281202272,1281202272,헤어프렌즈미용실,8,1,1,10
1900,s1486170722,1486170722,끌로이미장원,8,1,1,10
1901,s1401927174,1401927174,인생머리,8,1,1,10
1902,s1057893597,1057893597,MIIJA,7,1,1,9
1903,s37918463,37918463,비엠헤어다이스 6호점,4,1,4,9
1904,s19365874,19365874,콤마헤어,7,1,1,9
1905,s1064917312,1064917312,이든헤어,7,1,1,9
1906,s1766222075,1766222075,헤어한다,7,1,1,9
1907,s1159263723,1159263723,3H,1,1,7,9
1908,s1214144289,1214144289,오즈헤어,7,1,1,9
1909,s38729447,38729447,연 헤어코즈,6,1,2,9
1910,s32514740,32514740,낭만미장소,1,1,7,9
1911,s1099637208,1099637208,세종헤어 가락상떼빌점,6,1,2,9
1912,s823202480,823202480,크로커스헤어,5,1,3,9
1913,s38765845,38765845,로쉬헤어&스토어,6,1,2,9
1914,s36874122,36874122,제오헤어 홍제점,1,1,7,9
1915,s30858665,30858665,헤르덴헤어,4,1,4,9
1916,s34849681,34849681,살롱엘라,7,1,1,9
1917,s1341451499,1341451499,강실장 헤어살롱,7,1,1,9
1918,s13472267,13472267,디디앤디 헤어라운지,5,1,3,9
1919,s13434409,13434409,바이미가 그린라벨,1,1,7,9
1920,s21607662,21607662,벨라헤어,1,1,7,9
1921,s1262650862,1262650862,9월헤어살롱,4,1,4,9
1922,s1233155650,1233155650,눈부신하루를,7,1,1,9
1923,s1056773587,1056773587,채진미장원CLASSJIN,7,1,1,9
1924,s37811931,37811931,헤어바이혁,4,1,4,9
1925,s32891203,32891203,엘누에보헤어라운지,1,1,7,9
1926,s1377489285,1377489285,가위소리,7,1,1,9
1927,s1575119094,1575119094,바나니헤어에틀리에,7,1,1,9
1928,s1760262106,1760262106,살롱드데아,6,1,2,9
1929,s67591090,67591090,다름머리,1,1,7,9
1930,s21074435,21074435,온새미로,1,1,7,9
1931,s33703670,33703670,살롱드에비뉴 천호점,6,1,2,9
1932,s37898379,37898379,프로젝트라빠헤어 우장산점,1,1,7,9
1933,s11728816,11728816,나이스가이 여의도점,1,1,7,9
1934,s1572500138,1572500138,알렉산드르드파리 그레이스점,1,1,7,9
1935,s21336744,21336744,리안헤어 서울대입구역점,6,1,2,9
1936,s737765155,737765155,지노헤어 한성대점,6,1,2,9
1937,s13147261,13147261,미랑컬헤어 행당역점,1,1,7,9
1938,s1356837400,1356837400,마주봄 헤어,6,1,2,9
1939,s1941387660,1941387660,도도헤어살롱,7,1,1,9
1940,s1591880444,1591880444,심스헤어,3,1,5,9
1941,s37742097,37742097,금화미장,1,1,7,9
1942,s20742431,20742431,장헤어스토리,1,1,7,9
1943,s1600376887,1600376887,유엔나헤어,7,1,1,9
1944,s1626418975,1626418975,솜시헤어,7,1,1,9
1945,s1130951574,1130951574,제이룸헤어살롱,7,1,1,9
1946,s1436052704,1436052704,다빈헤어,3,1,5,9
1947,s1153324868,1153324868,HAIR 마루한,7,1,1,9
1948,s1722698781,1722698781,헤어살롱 택하다,7,1,1,9
1949,s13487078,13487078,아이펠마르 구로점,3,1,5,9
1950,s32528267,32528267,프랑크프로보 가로수길점,1,1,7,9
1951,s1501147863,1501147863,어베일헤어,1,1,7,9
1952,s1013252312,1013252312,투비살롱,7,1,1,9
1953,s38509796,38509796,CBHL,6,1,2,9
1954,s1770814372,1770814372,한결꾸밈,3,1,5,9
1955,s32430171,32430171,마벨헤어,1,1,7,9
1956,s1833555168,1833555168,올림 뷰티,7,1,1,9
1957,s1160965149,1160965149,벤헤어,7,1,1,9
1958,s1708040115,1708040115,예's 헤어,7,1,1,9
1959,s1975179410,1975179410,트리코드헤어살롱 by이철 마곡나루역점,7,1,1,9
1960,s1686450843,1686450843,에이더헤어,6,1,2,9
1961,s37932472,37932472,벨라헤어,1,1,7,9
1962,s36271299,36271299,오다헤어 옥수점,7,1,1,9
1963,s31293072,31293072,한's헤어,1,1,7,9
1964,s1711398307,1711398307,굿디,7,1,1,9
1965,s12854290,12854290,리안헤어 신세계남대문점,1,1,7,9
1966,s37916024,37916024,에리카헤어 홍대점,2,1,6,9
1967,s1387107340,1387107340,박철헤어,2,1,6,9
1968,s13430130,13430130,아이펠마르 난향점,7,1,1,9
1969,s1905577265,1905577265,더예쁜헤어,5,1,3,9
1970,s13151371,13151371,리안헤어 후암점,7,1,1,9
1971,s1135271380,1135271380,H스타일헤어살롱 성수점,7,1,1,9
1972,s38641796,38641796,어반헤어,7,1,1,9
1973,s1632736989,1632736989,뷰티살롱수다,4,1,4,9
1974,s38511407,38511407,0429헤어,4,1,4,9
1975,s233466194,233466194,아이앤투헤어 명지대점,7,1,1,9
1976,s11548559,11548559,다크헤어,4,1,4,9
1977,s1498762348,1498762348,BARBER693,1,1,7,9
1978,s1638695897,1638695897,벨라로그,6,1,1,8
1979,s1795054822,1795054822,모리스트릿헤어,5,2,1,8
1980,s36333415,36333415,헤어베네,1,1,6,8
1981,s37069366,37069366,살롱드콤마,6,1,1,8
1982,s1355798639,1355798639,라브리지 반포점,6,1,1,8
1983,s1184030643,1184030643,가까운헤어,6,1,1,8
1984,s32822222,32822222,에덴뷰티살롱,1,1,6,8
1985,s1106962976,1106962976,더 모스트 헤어살롱,6,1,1,8
1986,s1107658933,1107658933,루디아헤어,1,1,6,8
1987,s18235607,18235607,다름헤어 방배점,4,1,3,8
1988,s1793636796,1793636796,와이엔드헤어,6,1,1,8
1989,s1221697807,1221697807,H헤어,6,1,1,8
1990,s37243752,37243752,현앤현헤어,3,1,4,8
1991,s37765507,37765507,퍼스널헤어,1,1,6,8
1992,s38632934,38632934,다올헤어샵,1,1,6,8
1993,s1194825715,1194825715,리안헤어 행당역점,6,1,1,8
1994,s34786419,34786419,노향희헤어갤러리,1,1,6,8
1995,s38667798,38667798,코코로미헤어,1,1,6,8
1996,s1137932583,1137932583,살롱피키,6,1,1,8
1997,s38279737,38279737,라온제나헤어,1,1,6,8
1998,s36649040,36649040,미다스헤어,1,1,6,8
1999,s1363958385,1363958385,퀸보떼,6,1,1,8
2000,s1513171120,1513171120,니치헤어,5,1,2,8
2001,s31004063,31004063,헤드앤헤어미용실,2,1,5,8
2002,s1433829125,1433829125,GO HAIR,6,1,1,8
2003,s34159321,34159321,시연헤어,3,1,4,8
2004,s385538746,385538746,난길헤어,6,1,1,8
2005,s1479617372,1479617372,에코쟈뎅 낙성대점,6,1,1,8
2006,s37910456,37910456,꾸미게헤어,1,1,6,8
2007,s1888457428,1888457428,프로젝트 라빠헤어 건대점,1,1,6,8
2008,s33352128,33352128,오컷헤어,1,1,6,8
2009,s222490071,222490071,제이프롬헤어,6,1,1,8
2010,s1376598724,1376598724,아이앤투헤어 장승배기점,6,1,1,8
2011,s1787282820,1787282820,612ST,1,1,6,8
2012,s35254699,35254699,인팩트오타쿠 까치산점,1,1,6,8
2013,s38262309,38262309,헤어디엠마,1,1,6,8
2014,s13302336,13302336,uGone HAIR,4,1,3,8
2015,s1333016635,1333016635,하날살롱,6,1,1,8
2016,s37211148,37211148,이열헤어컷 1호점,6,1,1,8
2017,s747426862,747426862,살롱드마샹스,1,1,6,8
2018,s1921886665,1921886665,US 바버샵,1,1,6,8
2019,s36768742,36768742,패밀리헤어,6,1,1,8
2020,s1195737697,1195737697,옥수살롱바이봄,6,1,1,8
2021,s98331830,98331830,퍼스트헤어,6,1,1,8
2022,s292325267,292325267,레미샵 논현점,3,1,4,8
2023,s37814546,37814546,우영헤어 앤 네일,1,1,6,8
2024,s37090206,37090206,헤어플랜,1,1,6,8
2025,s12832058,12832058,세븐스트릿,1,1,6,8
2026,s1790911315,1790911315,이로헤어,4,1,3,8
2027,s1803310058,1803310058,살롱드마리,3,1,4,8
2028,s1118333577,1118333577,라브리지 잠실점,6,1,1,8
2029,s1011846561,1011846561,하이네스,1,1,6,8
2030,s1324013102,1324013102,헤어달디,6,1,1,8
2031,s1954123681,1954123681,J HAIR,6,1,1,8
2032,s945408564,945408564,easy&헤어,1,1,6,8
2033,s1924035233,1924035233,주니크살롱,1,1,6,8
2034,s38349738,38349738,안테나헤어,4,1,3,8
2035,s35572464,35572464,쟈당헤어,2,1,5,8
2036,s782720164,782720164,살롱데이 약수점,5,1,2,8
2037,s13151706,13151706,윤정선헤어클럽,1,1,6,8
2038,s1801507199,1801507199,JUST HAIR 1호점,6,1,1,8
2039,s1723182184,1723182184,살롱트루,5,1,2,8
2040,s1239826648,1239826648,ONL HAIR,6,1,1,8
2041,s1259708510,1259708510,comme roi,6,1,1,8
2042,s32448801,32448801,리안헤어 명동1호점,6,1,1,8
2043,s1696697649,1696697649,에스헤어,2,1,5,8
2044,s19542960,19542960,박승철헤어스투디오 구로롯데마트점,6,1,1,8
2045,s1860403368,1860403368,살롱드드림,2,1,5,8
2046,s1576682678,1576682678,헤어키키,6,1,1,8
2047,s807218276,807218276,올어바웃 헤어앤네일,1,1,6,8
2048,s1009586447,1009586447,아리아헤어,6,1,1,8
2049,s13399589,13399589,수인헤어,4,1,3,8
2050,s37392272,37392272,서해민미용실,1,1,6,8
2051,s37174916,37174916,플레이그라운드헤어,1,1,6,8
2052,s1704145454,1704145454,밀가헤어,2,1,5,8
2053,s814128312,814128312,신데렐라헤어,3,1,4,8
2054,s37653913,37653913,도이플루,1,1,6,8
2055,s1022634998,1022634998,머리합니다,6,1,1,8
2056,s38636380,38636380,마브로샵,1,1,6,8
2057,s1805864110,1805864110,제이헤어 헤어샵,6,1,1,8
2058,s37537948,37537948,김희경헤어그라또,6,1,1,8
2059,s35215481,35215481,가빈헤어,1,1,6,8
2060,s1884716058,1884716058,진이네미장원,4,1,3,8
2061,s1007313422,1007313422,헤어살롱mk,6,1,1,8
2062,s37192329,37192329,프라이빗,1,1,6,8
2063,s36317623,36317623,차랑헤어,1,1,6,8
2064,s1789875872,1789875872,커틸다헤어살롱 공릉점,1,1,6,8
2065,s37555920,37555920,스카이헤어,6,1,1,8
2066,s1751678591,1751678591,제이미용실,1,1,6,8
2067,s1593227414,1593227414,우선,1,1,6,8
2068,s1131384291,1131384291,살롱드앨리스강,5,1,2,8
2069,s1846714833,1846714833,엘뷰테라,1,1,6,8
2070,s18508418,18508418,세븐 헤어월드,1,1,6,8
2071,s1301399721,1301399721,엔헤어,1,1,6,8
2072,s37804056,37804056,미셸헤어,1,1,6,8
2073,s13447553,13447553,헤어 블러썸,1,1,6,8
2074,s1128049432,1128049432,김영옥헤어,1,1,5,7
2075,s37690714,37690714,더헤어바이윤,1,1,5,7
2076,s36061012,36061012,서지희헤어,5,1,1,7
2077,s37638351,37638351,앤드제이 헤어,1,1,5,7
2078,s36886381,36886381,헤어스토리,1,1,5,7
2079,s1573516849,1573516849,BIG STAR HAIR,4,1,2,7
2080,s1197075765,1197075765,에이데이즈 헤어살롱,5,1,1,7
2081,s32618528,32618528,야드,5,1,1,7
2082,s1576979257,1576979257,담다살롱,4,1,2,7
2083,s36189323,36189323,휴미용실,1,1,5,7
2084,s1168474153,1168474153,헤어로투스,5,1,1,7
2085,s839168648,839168648,리안헤어 영등포신세계점,5,1,1,7
2086,s36878324,36878324,썸헤어,4,1,2,7
2087,s32472992,32472992,오다헤어 낙성대점,4,1,2,7
2088,s30830863,30830863,리안헤어 송파개롱역점,5,1,1,7
2089,s21206912,21206912,체리헤어,1,1,5,7
2090,s36438860,36438860,드엔,1,1,5,7
2091,s1990571533,1990571533,헤어칩,5,1,1,7
2092,s1926807763,1926807763,연희부티끄헤어,5,1,1,7
2093,s1182378191,1182378191,ABC헤어 잠실새내역점,5,1,1,7
2094,s13359523,13359523,지산헤어스토리,1,1,5,7
2095,s1957458396,1957458396,푸루부,5,1,1,7
2096,s1171980888,1171980888,로드헤어샵,4,1,2,7
2097,s21900508,21900508,가위와빗 헤어살롱,5,1,1,7
2098,s37868786,37868786,미나살롱,1,1,5,7
2099,s1672570272,1672570272,엘라인헤어살롱,3,3,1,7
2100,s1762977808,1762977808,살롱 드 아우라,5,1,1,7
2101,s37198287,37198287,여우미가,1,1,5,7
2102,s1898005697,1898005697,여우짓붙임머리 홍대점,1,1,5,7
2103,s324100348,324100348,라벨르헤어,5,1,1,7
2104,s35524064,35524064,WM헤어 반포점,1,1,5,7
2105,s839207736,839207736,최가을헤어드레서 합정역점,1,1,5,7
2106,s1080245535,1080245535,끌리움헤어,5,1,1,7
2107,s858264190,858264190,이훈ALL30000 신촌본점,5,1,1,7
2108,s359974004,359974004,슬릭헤어살롱,1,1,5,7
2109,s13562307,13562307,김호증모 리헤어,1,1,5,7
2110,s1379197028,1379197028,느낌헤어,5,1,1,7
2111,s1630721610,1630721610,늘봄살롱,1,1,5,7
2112,s38571177,38571177,굿데이헤어살롱,1,1,5,7
2113,s1711172264,1711172264,어거스트헤어살롱,4,1,2,7
2114,s1050618349,1050618349,zoe by choi 헤어,5,1,1,7
2115,s194501951,194501951,진스헤어,1,1,5,7
2116,s1146044766,1146044766,미쓰홍 왁싱&속눈썹,1,1,5,7
2117,s279106698,279106698,F Moon hair,1,1,5,7
2118,s1674951872,1674951872,살롱압주 화이트점,5,1,1,7
2119,s38705794,38705794,지노헤어 숙대2호점,1,1,5,7
2120,s1456885794,1456885794,루시드헤어,5,1,1,7
2121,s1098177106,1098177106,다비드헤어,1,1,5,7
2122,s141511818,141511818,플랜에이치 우장산9호점,5,1,1,7
2123,s1330828836,1330828836,밀카헤어,5,1,1,7
2124,s1830086421,1830086421,제이헤어,1,1,5,7
2125,s36333582,36333582,청담서율HAIR,1,1,5,7
2126,s1602419842,1602419842,한올살롱,5,1,1,7
2127,s11670910,11670910,젠헤어 이대점,1,1,5,7
2128,s18765792,18765792,헤어라희,5,1,1,7
2129,s31469568,31469568,리타헤어,1,1,5,7
2130,s36763028,36763028,아티스트태양,1,1,5,7
2131,s1210223964,1210223964,아티나헤어,1,1,5,7
2132,s1227417274,1227417274,까망드헤어샵,5,1,1,7
2133,s1003619860,1003619860,살롱드로현,3,1,3,7
2134,s454207279,454207279,헤어오브지호,5,1,1,7
2135,s1018057747,1018057747,살롱드 바이 깁슨,5,1,1,7
2136,s37520577,37520577,이니지오미용실,2,1,4,7
2137,s1849551342,1849551342,정다운 미용실,5,1,1,7
2138,s523979537,523979537,J헤어,1,1,5,7
2139,s1268737665,1268737665,헤어닥터,1,1,5,7
2140,s1318102181,1318102181,24시 웅쓰헤어,1,1,5,7
2141,s1038893604,1038893604,쏘유헤어,5,1,1,7
2142,s36920175,36920175,다올헤어샵,1,1,5,7
2143,s1808445219,1808445219,준오헤어 대학로혜화역점,5,1,1,7
2144,s38299672,38299672,리챠드프로헤어 압구정점,1,1,5,7
2145,s1650557824,1650557824,살롱 드 루나,1,1,5,7
2146,s20643542,20643542,윤성애헤어클럽,5,1,1,7
2147,s1153061098,1153061098,더볼룸,5,1,1,7
2148,s36340880,36340880,SalonDe광봉Hair&Beauty,1,1,5,7
2149,s38701458,38701458,문헤어 M점,4,1,2,7
2150,s35112236,35112236,주헤어,1,1,5,7
2151,s1638542171,1638542171,제오헤어 염창역점,5,1,1,7
2152,s1095517776,1095517776,나의 봄 헤어,4,1,2,7
2153,s1377694944,1377694944,더예쁨샵,5,1,1,7
2154,s36028370,36028370,J4U헤어살롱,1,1,5,7
2155,s1943826491,1943826491,모도리헤어,1,1,5,7
2156,s13156025,13156025,살롱드스완,4,1,2,7
2157,s36424680,36424680,살롱드수작,1,1,5,7
2158,s13084768,13084768,마샬뷰티살롱 논현점,2,1,4,7
2159,s31833590,31833590,미즈헤어,1,1,5,7
2160,s1621798413,1621798413,헤어 바이길로,5,1,1,7
2161,s37221165,37221165,리안헤어 신곡시장점,5,1,1,7
2162,s32434608,32434608,미랑컬헤어 신정네거리역점,5,1,1,7
2163,s937494258,937494258,이훈ALL30000 낙성대점,1,1,5,7
2164,s21688556,21688556,헤어오클리,1,1,5,7
2165,s1687397007,1687397007,헤어살롱 라보떼,1,1,5,7
2166,s1656581353,1656581353,노을미용실,5,1,1,7
2167,s1495445786,1495445786,청아살롱,5,1,1,7
2168,s12989035,12989035,스타일플로어 임진옥,1,1,5,7
2169,s1410468948,1410468948,에이유젠,5,1,1,7
2170,s38591691,38591691,더헤어 연신내점,1,1,5,7
2171,s603880835,603880835,고수헤어,5,1,1,7
2172,s1748738166,1748738166,폴스바버샵,4,1,2,7
2173,s1297536789,1297536789,써니헤어,1,1,5,7
2174,s38448603,38448603,헤어크루,1,1,5,7
2175,s21007306,21007306,아이벨르 압구정본점,2,1,4,7
2176,s1538679620,1538679620,헤어스튜디오 봄,5,1,1,7
2177,s1895495478,1895495478,헤이즈 헤어,5,1,1,7
2178,s1780653098,1780653098,브로스헤어,5,1,1,7
2179,s1610336854,1610336854,우미룸,3,1,2,6
2180,s1771686534,1771686534,Le mer,1,1,4,6
2181,s36341125,36341125,엠플러스,1,1,4,6
2182,s38591454,38591454,샵헤어,1,1,4,6
2183,s1907022371,1907022371,드 레브,1,1,4,6
2184,s36561036,36561036,릴리프헤어 반포점,1,1,4,6
2185,s37812518,37812518,라떼뜨,1,1,4,6
2186,s572371339,572371339,엣지헤어샵,1,1,4,6
2187,s13091619,13091619,컬리헤어,1,1,4,6
2188,s1828539650,1828539650,오늘의살롱,1,1,4,6
2189,s1239757061,1239757061,헤어롤미용실,1,1,4,6
2190,s37432691,37432691,더 하우스 가좌점,3,1,2,6
2191,s1844310023,1844310023,아이레,4,1,1,6
2192,s37351313,37351313,헤어스테이지 미용실,2,1,3,6
2193,s33237851,33237851,아틀리에헤어,1,1,4,6
2194,s13450852,13450852,마타헤어하우스,3,1,2,6
2195,s36630867,36630867,스타일그루에스,1,1,4,6
2196,s1431315944,1431315944,아누헤어,4,1,1,6
2197,s34490065,34490065,수헤어스토리,1,1,4,6
2198,s11841034,11841034,에반스타일,1,1,4,6
2199,s1096239007,1096239007,바이 에스,4,1,1,6
2200,s163751725,163751725,H O HAIR,1,1,4,6
2201,s37993364,37993364,헤어 바이 감성,1,1,4,6
2202,s695931605,695931605,라라헤어,4,1,1,6
2203,s345687250,345687250,미고헤어,1,1,4,6
2204,s1837121474,1837121474,Salon610,1,1,4,6
2205,s11731293,11731293,하이크라스 미용실,1,1,4,6
2206,s1507737534,1507737534,스타일리스트헤어,4,1,1,6
2207,s38654957,38654957,순수한헤어,4,1,1,6
2208,s1535999585,1535999585,뷰티살롱 아미,4,1,1,6
2209,s1097600947,1097600947,리에주헤어,4,1,1,6
2210,s1273199731,1273199731,아틀리에민진,1,1,4,6
2211,s1484287446,1484287446,언니네헤어,2,1,3,6
2212,s37838081,37838081,헤어포텐,1,1,4,6
2213,s181566171,181566171,데이지,1,1,4,6
2214,s1753869578,1753869578,옥이네미장원,1,1,4,6
2215,s1004419720,1004419720,다옴헤어,1,1,4,6
2216,s351421518,351421518,나눌헤어,1,1,4,6
2217,s1355736969,1355736969,오샤레 헤어살롱,4,1,1,6
2218,s1018527021,1018527021,산책헤어,1,1,4,6
2219,s1569014071,1569014071,로사헤어,4,1,1,6
2220,s20550773,20550773,하루헤어뜰,1,1,4,6
2221,s1003402787,1003402787,나이스가이 여의도63점,1,1,4,6
2222,s864449749,864449749,조앤헤어,2,1,3,6
2223,s1789310599,1789310599,살롱드모모,4,1,1,6
2224,s36803944,36803944,용군샵,4,1,1,6
2225,s163992031,163992031,머리지음,1,1,4,6
2226,s34325441,34325441,손빛지예,1,1,4,6
2227,s21202383,21202383,헤어메세3,1,1,4,6
2228,s1151130961,1151130961,머리친구,4,1,1,6
2229,s36321554,36321554,천경숙헤어,1,1,4,6
2230,s1146827903,1146827903,케이룸,1,1,4,6
2231,s33928526,33928526,우선제헤어루시,1,1,4,6
2232,s1575723600,1575723600,나이스가이 잠실역점,1,1,4,6
2233,s1660851571,1660851571,루아헤어&스토어,4,1,1,6
2234,s1073357697,1073357697,나뷰티살롱,4,1,1,6
2235,s33284188,33284188,마키하우스,1,1,4,6
2236,s1080337714,1080337714,위앤위헤어,4,1,1,6
2237,s1515198983,1515198983,꼬뜨헤어살롱,4,1,1,6
2238,s36883089,36883089,살랑,1,1,4,6
2239,s218844858,218844858,비나인헤어,4,1,1,6
2240,s33418707,33418707,간지헤어 2호점,1,1,4,6
2241,s1857935795,1857935795,에필라쥬 헤어살롱,4,1,1,6
2242,s1129804978,1129804978,헤어프로방스,1,1,4,6
2243,s37373398,37373398,1층 미용실 엄쏭,3,1,2,6
2244,s36873960,36873960,보이지않는차이 Advance,1,1,4,6
2245,s1764496843,1764496843,히로헤어살롱,1,1,4,6
2246,s1500944826,1500944826,나임헤어,4,1,1,6
2247,s32390097,32390097,스타일 브로우바,1,1,4,6
2248,s1989489329,1989489329,케렌시아헤어,1,1,4,6
2249,s1226675936,1226675936,앙비떼살롱,4,1,1,6
2250,s925703653,925703653,라본헤어 강남점,1,1,4,6
2251,s1609919054,1609919054,헤어아셀,3,1,2,6
2252,s1503664740,1503664740,NARA&G HAIR,3,1,2,6
2253,s1102580435,1102580435,1988,4,1,1,6
2254,s154070837,154070837,박승철헤어스투디오 서울대점,1,1,4,6
2255,s1061861244,1061861244,라청담미용실,3,1,2,6
2256,s1020764835,1020764835,포메이드헤어,1,1,4,6
2257,s37990474,37990474,헤어망고 잠실신천점,1,1,4,6
2258,s37767311,37767311,헤어바이반룬하우트 행당점,3,1,2,6
2259,s1514021838,1514021838,루시헤어,4,1,1,6
2260,s1100245850,1100245850,예진샵,4,1,1,6
2261,s1565940367,1565940367,로이드밤 장안점,4,1,1,6
2262,s656353789,656353789,홍주헤어앤메이크업,1,1,4,6
2263,s38508512,38508512,뮤셈헤어,1,1,4,6
2264,s1704107284,1704107284,크랭크헤어스튜디오 청량리점,1,1,4,6
2265,s364751568,364751568,블리치샵,1,1,4,6
2266,s1841511937,1841511937,다시스물,1,1,4,6
2267,s37038973,37038973,김환헤어디자인,1,1,4,6
2268,s13506298,13506298,이가자헤어비스 가든파이브점,1,1,4,6
2269,s37992417,37992417,요즘헤어,1,1,4,6
2270,s34015688,34015688,메시헤어,1,1,4,6
2271,s1829456737,1829456737,연이네쌀롱,4,1,1,6
2272,s123586853,123586853,J HAIR,1,1,4,6
2273,s1901513835,1901513835,지앤미헤어,4,1,1,6
2274,s817407288,817407288,헤어프롬디,1,1,4,6
2275,s31098531,31098531,투헤어,4,1,1,6
2276,s1731065406,1731065406,유잇다,1,1,4,6
2277,s1750362816,1750362816,미듬헤어살롱,4,1,1,6
2278,s1048308070,1048308070,꽃미용실,4,1,1,6
2279,s1072974761,1072974761,가교,4,1,1,6
2280,s1479267616,1479267616,부티부살롱,1,1,4,6
2281,s1569443785,1569443785,지나헤어,1,1,4,6
2282,s1789622743,1789622743,나이스가이 역삼점,1,1,4,6
2283,s63499558,63499558,메르시헤어,2,1,3,6
2284,s1218216583,1218216583,보아헤어,3,1,2,6
2285,s35156999,35156999,공입수헤어갤러리,1,1,4,6
2286,s36233225,36233225,설레임헤어,1,1,4,6
2287,s1005120651,1005120651,자연주의 먹는 펌 헤어,4,1,1,6
2288,s37703480,37703480,스틸앤스톤,1,1,4,6
2289,s36936246,36936246,해방촌미용실,3,1,2,6
2290,s1686245259,1686245259,RE born hair,4,1,1,6
2291,s1834390651,1834390651,수아라헤어 신월점,4,1,1,6
2292,s660029722,660029722,APRON hair,1,1,4,6
2293,s1878809485,1878809485,나이스가이 DMC가재울점,1,1,4,6
2294,s1653247827,1653247827,성수살롱,1,1,4,6
2295,s1849897319,1849897319,레드썬,1,1,4,6
2296,s33869032,33869032,RROMANI,3,1,2,6
2297,s1910653402,1910653402,992헤어,1,1,4,6
2298,s1246014854,1246014854,영아쌀롱,4,1,1,6
2299,s1837382704,1837382704,정준헤어클럽,2,1,3,6
2300,s20234119,20234119,알레이 잠실점,1,1,4,6
2301,s1903533439,1903533439,살롱드브리에,4,1,1,6
2302,s1947975622,1947975622,오늘 헤어,4,1,1,6
2303,s38642518,38642518,리안헤어 개봉푸르지오점,3,1,1,5
2304,s1123885968,1123885968,아티자노헤어,3,1,1,5
2305,s802952359,802952359,아일리아헤어 창동점,1,1,3,5
2306,s37278168,37278168,준앤안티 고덕점,1,1,3,5
2307,s13592219,13592219,더에이,1,1,3,5
2308,s258013837,258013837,라이온헤어,1,1,3,5
2309,s32241271,32241271,오다헤어 명동점,1,1,3,5
2310,s36438460,36438460,헤어작업실,1,1,3,5
2311,s1128122344,1128122344,에크루헤어,1,1,3,5
2312,s1163111198,1163111198,누브아,1,1,3,5
2313,s888244277,888244277,더꾼헤어,1,1,3,5
2314,s12794932,12794932,버블스토리 NC백화점불광점,1,1,3,5
2315,s1315696965,1315696965,한나쌀롱,3,1,1,5
2316,s33299911,33299911,헤어아모르,1,1,3,5
2317,s1264362402,1264362402,블로우,1,1,3,5
2318,s1434113622,1434113622,영이샵헤어,1,1,3,5
2319,s35244066,35244066,자스민헤어살롱,1,1,3,5
2320,s34853671,34853671,W hair&make up,1,1,3,5
2321,s1279218542,1279218542,살롱드봄봄,1,1,3,5
2322,s37186484,37186484,리안헤어 경희대점,3,1,1,5
2323,s1202754853,1202754853,스위트벙커 발산4지점,1,1,3,5
2324,s37742112,37742112,살롱드공간,1,1,3,5
2325,s1332789572,1332789572,살롱드끌림,1,1,3,5
2326,s32821863,32821863,스타일제이헤어,1,1,3,5
2327,s38673745,38673745,더모스트,3,1,1,5
2328,s20838900,20838900,가와이헤어 쟁이No1,1,1,3,5
2329,s18341957,18341957,데이빗헤어살롱,1,1,3,5
2330,s1382032176,1382032176,열두달미장원,1,1,3,5
2331,s1609933553,1609933553,제이미헤어,3,1,1,5
2332,s34436850,34436850,오다헤어 광운대역점,3,1,1,5
2333,s1763625020,1763625020,토리헤어 발산점,1,3,1,5
2334,s1420533119,1420533119,엘리자베스헤어,1,1,3,5
2335,s1911396028,1911396028,라벨르헤어,2,1,2,5
2336,s32496464,32496464,사틴헤어 삼성역점,1,1,3,5
2337,s1090057132,1090057132,컬투헤어,3,1,1,5
2338,s1642117760,1642117760,하담헤어,1,1,3,5
2339,s1116676818,1116676818,안테나헤어 양재역점,1,1,3,5
2340,s18467381,18467381,헤어앤바이서은경,1,1,3,5
2341,s38327670,38327670,헤어리브레,1,1,3,5
2342,s36874243,36874243,스타일리스트,3,1,1,5
2343,s440948096,440948096,보니헤어,2,1,2,5
2344,s38300119,38300119,베르디헤어,1,1,3,5
2345,s13156650,13156650,인투헤어 1호점,1,1,3,5
2346,s35051955,35051955,W헤어,1,1,3,5
2347,s1287060154,1287060154,The 꾸미다,2,1,2,5
2348,s37638577,37638577,라움헤어,1,1,3,5
2349,s35727194,35727194,꿈결헤어,1,1,3,5
2350,s38337267,38337267,2M헤어,1,1,3,5
2351,s1257432319,1257432319,나눌헤어 목동점,1,3,1,5
2352,s34359560,34359560,셀라비헤어,1,1,3,5
2353,s1809606242,1809606242,HM Hair,1,1,3,5
2354,s12819742,12819742,마니아미용실,1,1,3,5
2355,s1563222749,1563222749,카일리헤어,3,1,1,5
2356,s1977344048,1977344048,미장원by연,3,1,1,5
2357,s36667741,36667741,조희미용실,3,1,1,5
2358,s1727356740,1727356740,오라헤어,1,1,3,5
2359,s1222846551,1222846551,에스엘 헤어,3,1,1,5
2360,s37615245,37615245,미자르헤어,1,1,3,5
2361,s1612223068,1612223068,살롱드제이,3,1,1,5
2362,s1218427419,1218427419,에스뷰티헤어살롱,3,1,1,5
2363,s34850174,34850174,보떼드소준,1,1,3,5
2364,s20994406,20994406,살롱 드 브로,1,1,3,5
2365,s1656483618,1656483618,휴스토리,1,1,3,5
2366,s36428345,36428345,이철헤어커커 중앙대후문점,1,1,3,5
2367,s31556012,31556012,미꼬헤어,1,1,3,5
2368,s1829885999,1829885999,페퍼민트헤어,1,1,3,5
2369,s1418353294,1418353294,헤어사냥꾼,1,1,3,5
2370,s37122733,37122733,지노헤어 노원역점,1,1,3,5
2371,s916279830,916279830,터치스비,1,1,3,5
2372,s37837993,37837993,루디아 미용실,1,1,3,5
2373,s1469809013,1469809013,아르떼헤어,3,1,1,5
2374,s38279801,38279801,헤어엠코드,1,1,3,5
2375,s355437875,355437875,유니코헤어 약수점,1,1,3,5
2376,s38641823,38641823,호야즈룸,1,1,3,5
2377,s33704448,33704448,김지연살롱에이 스타일바이,1,1,3,5
2378,s1575213420,1575213420,뷰티세라헤어,1,1,3,5
2379,s13355182,13355182,노주원헤어그라프,3,1,1,5
2380,s1381608187,1381608187,정하연헤어살롱,2,1,2,5
2381,s35452115,35452115,셰르헤어,3,1,1,5
2382,s35515899,35515899,ys헤어,1,1,3,5
2383,s1713716278,1713716278,끌리지헤어,1,1,3,5
2384,s11713770,11713770,다다헤어,1,1,3,5
2385,s1069011572,1069011572,네이처헤어 강일동점,3,1,1,5
2386,s1096975271,1096975271,레미샵 홍대점,2,1,2,5
2387,s34350376,34350376,가위놀이,1,1,3,5
2388,s37879391,37879391,리안헤어 가산점,3,1,1,5
2389,s1673055531,1673055531,미용헤어,2,1,2,5
2390,s1137117159,1137117159,나나랜드헤어,1,1,3,5
2391,s1657412333,1657412333,볼륨트리헤어,1,1,3,5
2392,s1252312797,1252312797,더하우스헤어,1,1,3,5
2393,s37495756,37495756,박숙경헤어살롱,3,1,1,5
2394,s1530257709,1530257709,에이치헤어샵,3,1,1,5
2395,s1476927483,1476927483,살롱모옹,1,1,3,5
2396,s1385935550,1385935550,Mood House,1,1,3,5
2397,s37082054,37082054,비엠헤어다이스 역삼2호점,3,1,1,5
2398,s1600983467,1600983467,756헤어,2,1,2,5
2399,s36470071,36470071,라벨르헤어,1,1,3,5
2400,s1968504756,1968504756,살롱오래오,1,1,3,5
2401,s38555843,38555843,토리헤어 노원역점,1,2,2,5
2402,s31378453,31378453,앨리스,1,1,3,5
2403,s1435974141,1435974141,여름살롱,1,1,3,5
2404,s1786168297,1786168297,으니샵,3,1,1,5
2405,s1874098567,1874098567,일리아바이영주 대치점,1,1,3,5
2406,s1688642404,1688642404,피다헤어  미용실,3,1,1,5
2407,s1043065769,1043065769,앤코헤어,3,1,1,5
2408,s1775785111,1775785111,바움헤어,2,1,2,5
2409,s1270808296,1270808296,하리다미장원,3,1,1,5
2410,s1278780823,1278780823,아름디헤어,3,1,1,5
2411,s1912696409,1912696409,착한미용실원투쓰리 건대점,1,2,2,5
2412,s21407110,21407110,MJ헤어,1,1,3,5
2413,s32183173,32183173,조국현뷰티스윗,1,1,3,5
2414,s37221586,37221586,린헤어,1,1,3,5
2415,s13459834,13459834,비단헤어,1,1,3,5
2416,s1715945037,1715945037,One's Salon,3,1,1,5
2417,s590885146,590885146,올리브헤어,3,1,1,5
2418,s20373003,20373003,미랑컬헤어 화곡2동점,1,1,3,5
2419,s1680059900,1680059900,훈 헤어아트,2,1,2,5
2420,s20924261,20924261,데자뷰헤어,1,1,3,5
2421,s1046254737,1046254737,리안헤어 서울역서부점,3,1,1,5
2422,s1307137097,1307137097,헤어아티스트M 본사,1,1,3,5
2423,s365328898,365328898,포인트헤어,1,1,3,5
2424,s1780549694,1780549694,에르아룸,3,1,1,5
2425,s1961361127,1961361127,보다헤어,3,1,1,5
2426,s1567973203,1567973203,W헤어동묘역점,3,1,1,5
2427,s34658788,34658788,더공감헤어 성내점,3,1,1,5
2428,s13457304,13457304,Lee헤어,1,1,3,5
2429,s38019526,38019526,0820미용실,1,1,3,5
2430,s18397835,18397835,예삐오 ABO BCVC BYHONG,1,1,3,5
2431,s1659898847,1659898847,수미살롱,1,1,3,5
2432,s1485298056,1485298056,지노헤어 구로디지털단지역점,3,1,1,5
2433,s1146280373,1146280373,지노헤어 오류점,1,1,3,5
2434,s35586030,35586030,카미유헤어,3,1,1,5
2435,s57863369,57863369,살롱드와이,1,1,3,5
2436,s37362276,37362276,핀다,1,1,3,5
2437,s35195105,35195105,리안헤어 창동어울림점,2,1,2,5
2438,s635870465,635870465,자비헤어,3,1,1,5
2439,s1528869261,1528869261,살롱드 그레이시티,1,1,3,5
2440,s1903747510,1903747510,iyyu,2,1,2,5
2441,s37033590,37033590,N5Hair,3,1,1,5
2442,s20867445,20867445,양스헤어,2,1,2,5
2443,s1773240297,1773240297,수리헤어살롱,2,1,2,5
2444,s658226374,658226374,my name is 영웅. 헤어&탈모,3,1,1,5
2445,s38767096,38767096,스타일리스트jy,3,1,1,5
2446,s1142150688,1142150688,더구름헤어살롱,3,1,1,5
2447,s33068431,33068431,키즈헤어타임,1,1,3,5
2448,s21888999,21888999,헤어작업실,1,1,3,5
2449,s36018893,36018893,비비엔느헤어,3,1,1,5
2450,s1561202959,1561202959,헤어바이602,1,3,1,5
2451,s584667177,584667177,더헤어 중랑점,1,1,3,5
2452,s36351269,36351269,라떼뜨헤어,1,1,3,5
2453,s1009973216,1009973216,비엠커트전문점,3,1,1,5
2454,s95154511,95154511,누벨르,2,1,2,5
2455,s1734489485,1734489485,나이스가이 공덕점,1,1,3,5
2456,s38488719,38488719,헤어빠,1,1,3,5
2457,s20119125,20119125,헤어드헤레나,1,1,3,5
2458,s37351029,37351029,W헤어,3,1,1,5
2459,s1948739766,1948739766,넘버원헤어살롱,1,1,3,5
2460,s77848624,77848624,어썸헤어,1,1,3,5
2461,s1580051469,1580051469,보빈헤어,2,1,2,5
2462,s32779303,32779303,꾸아퍼스트 무역현대점,1,1,3,5
2463,s38525674,38525674,드보르 이태원점,1,1,3,5
2464,s1804750013,1804750013,살롱드엘,1,1,3,5
2465,s13580137,13580137,디하문바이공주,3,1,1,5
2466,s38576418,38576418,사틴헤어 불광역점,2,1,2,5
2467,s295019385,295019385,포레스타스프링 위례점,3,1,1,5
2468,s1751620491,1751620491,De belle,1,1,3,5
2469,s1202936404,1202936404,디헤어,1,1,3,5
2470,s1530490875,1530490875,헤드마스터,1,1,3,5
2471,s1016407044,1016407044,재키즈 백스테이지,1,1,3,5
2472,s820275320,820275320,제인헤어,3,1,1,5
2473,s880595937,880595937,라이블리더뷰티헤어,1,1,3,5
2474,s36667595,36667595,강남순헤어,1,1,3,5
2475,s1999812929,1999812929,헤어디자인모습 두번째점,1,1,2,4
2476,s1809987514,1809987514,오버플로우헤어,1,1,2,4
2477,s1121179319,1121179319,은샵,1,1,2,4
2478,s1069634711,1069634711,정환헤어샵,1,1,2,4
2479,s1435315346,1435315346,봄날,1,1,2,4
2480,s18658560,18658560,선영아사랑해,1,1,2,4
2481,s1285752668,1285752668,리사뷰티살롱,1,2,1,4
2482,s38738620,38738620,리안헤어 신길썬프라자점,2,1,1,4
2483,s1537230900,1537230900,엠블랑헤어,2,1,1,4
2484,s1201076423,1201076423,헤어바이재희,1,1,2,4
2485,s1587337575,1587337575,반하다살롱,2,1,1,4
2486,s1200416150,1200416150,"이,순간헤어",1,1,2,4
2487,s1202818954,1202818954,아벨리아헤어,2,1,1,4
2488,s1133621774,1133621774,세종헤어 헬리오시티점,1,1,2,4
2489,s1695187210,1695187210,Tu es Belle,1,1,2,4
2490,s1744583122,1744583122,GTB Hair&Make up,1,1,2,4
2491,s1301286831,1301286831,덕앤클리퍼,1,1,2,4
2492,s1761173951,1761173951,슬레이하우스,1,1,2,4
2493,s1538630324,1538630324,헤어망고 독산점,2,1,1,4
2494,s20633072,20633072,아이비헤어살롱,1,1,2,4
2495,s13168392,13168392,크레이머 파리 헤어살롱 오페라,1,1,2,4
2496,s1205136662,1205136662,아델비스,1,1,2,4
2497,s20735401,20735401,마샬뷰티살롱명동본점,1,1,2,4
2498,s879228038,879228038,리오헤어3 길동점,2,1,1,4
2499,s13492724,13492724,본연애헤어 묵동점,1,1,2,4
2500,s1383808113,1383808113,이끼헤어,1,1,2,4
2501,s37658986,37658986,베니티앤코헤어살롱,1,1,2,4
2502,s13372471,13372471,박준뷰티랩 롯데송파점,1,2,1,4
2503,s31392501,31392501,마리앤두헤어,2,1,1,4
2504,s412502391,412502391,씨크헤어,2,1,1,4
2505,s1785282218,1785282218,쌀롱오브슬아,2,1,1,4
2506,s34482171,34482171,헤어헤리티지문래점,1,1,2,4
2507,s1877652512,1877652512,아일리스,1,1,2,4
2508,s38667865,38667865,박철헤어,1,1,2,4
2509,s1258674031,1258674031,이오엘헤어,1,1,2,4
2510,s1194138505,1194138505,The 공감 hair,1,1,2,4
2511,s21033877,21033877,세마헤어 홍대점,1,1,2,4
2512,s1176394521,1176394521,민경샵,2,1,1,4
2513,s519660320,519660320,미가헤어샵,1,1,2,4
2514,s36466158,36466158,마에스트로헤어수서역점,1,1,2,4
2515,s38328576,38328576,토리헤어 독산점,1,1,2,4
2516,s1413329403,1413329403,대니헤어,2,1,1,4
2517,s13395244,13395244,이훈헤어칼라 미아점,1,1,2,4
2518,s1903744975,1903744975,아르뉴헤어디자인,2,1,1,4
2519,s1346499865,1346499865,라즈모 랩,2,1,1,4
2520,s21638346,21638346,S TA HAIR,1,1,2,4
2521,s1584229627,1584229627,욜로헤어,1,1,2,4
2522,s37937194,37937194,이훈ALL30000 응암점,2,1,1,4
2523,s18185080,18185080,헤어뉴스 더 레드,1,1,2,4
2524,s1794964810,1794964810,엘샤코로,2,1,1,4
2525,s37057397,37057397,장폴헤어살롱,1,1,2,4
2526,s1681983732,1681983732,착한헤어감동,1,1,2,4
2527,s37587327,37587327,몬스터 헤어,2,1,1,4
2528,s75844037,75844037,로아나헤어,2,1,1,4
2529,s1988468819,1988468819,더137헤어,1,1,2,4
2530,s20916461,20916461,서상우헤어,1,1,2,4
2531,s81495489,81495489,1987헤어,1,1,2,4
2532,s31462428,31462428,시류,2,1,1,4
2533,s1262482281,1262482281,Salon de HARU,2,1,1,4
2534,s1057914853,1057914853,나만의미용실,2,1,1,4
2535,s37445299,37445299,아크미미용실,1,1,2,4
2536,s1699337590,1699337590,오늘도봄,2,1,1,4
2537,s1268092204,1268092204,헤어드그라,2,1,1,4
2538,s13372469,13372469,박준뷰티랩 신반포역점,2,1,1,4
2539,s1237378516,1237378516,베스띠헤어,1,1,2,4
2540,s807399484,807399484,리안헤어 신월7동점,1,1,2,4
2541,s20828050,20828050,히즈모 동부이촌점,1,2,1,4
2542,s845277454,845277454,Dr지은 두피탈모전문&헤어,2,1,1,4
2543,s241880155,241880155,슈가헤어 수유역점,1,1,2,4
2544,s37902797,37902797,헤어디자이너 이상,1,1,2,4
2545,s1974965997,1974965997,조이헤어,1,1,2,4
2546,s1288371703,1288371703,다옴헤어앤네일,1,1,2,4
2547,s1940681588,1940681588,예쁜나,1,1,2,4
2548,s1153136873,1153136873,아르스에이치,1,1,2,4
2549,s13132142,13132142,펑크샬롬,1,1,2,4
2550,s20888578,20888578,더함헤어,2,1,1,4
2551,s1889944920,1889944920,지노이만헤어,2,1,1,4
2552,s1172080467,1172080467,살롱존씨,2,1,1,4
2553,s38286957,38286957,BHJ 헤어스토리,1,1,2,4
2554,s1808488321,1808488321,더에이치제이 살롱,1,1,2,4
2555,s36666071,36666071,SODA HAIR,1,1,2,4
2556,s94458409,94458409,힐링헤어,1,1,2,4
2557,s1347095151,1347095151,월간헤어,1,1,2,4
2558,s1722140006,1722140006,루이스,2,1,1,4
2559,s515881059,515881059,K헤어살롱,2,1,1,4
2560,s1468395990,1468395990,헤어1번가,1,2,1,4
2561,s1000552286,1000552286,제이바비붙임머리,1,1,2,4
2562,s31777860,31777860,더레이디 서울본점,1,1,2,4
2563,s18206329,18206329,주주헤어 공릉본점,1,1,2,4
2564,s1311130625,1311130625,뷰티포스마일,1,1,2,4
2565,s1040161454,1040161454,꾸밈헤어,2,1,1,4
2566,s37203285,37203285,토리헤어 잠실레이크점,1,1,2,4
2567,s20300199,20300199,포레스타 반얀트리점,1,1,2,4
2568,s1091795710,1091795710,머리하는날,1,1,2,4
2569,s36303975,36303975,우정민헤어,2,1,1,4
2570,s36351286,36351286,We Hair,1,2,1,4
2571,s36178201,36178201,헤어멘토,2,1,1,4
2572,s1392689989,1392689989,살롱 드 장미,1,1,2,4
2573,s20907995,20907995,도미용실,1,2,1,4
2574,s1441100040,1441100040,MOON HAIR SALON,1,1,2,4
2575,s769165491,769165491,헤어스파,1,1,2,4
2576,s37936276,37936276,미정살롱,1,1,2,4
2577,s1186387386,1186387386,정하나헤어3호점,1,1,2,4
2578,s13150865,13150865,미안헤어,1,1,2,4
2579,s1718618926,1718618926,해아 에비뉴,1,1,2,4
2580,s1212443213,1212443213,연hair,2,1,1,4
2581,s1258210289,1258210289,브이헤어,2,1,1,4
2582,s1440463147,1440463147,크리헤어티브,2,1,1,4
2583,s36192451,36192451,차헤어샵,1,1,2,4
2584,s13534924,13534924,준호프로헤어,1,1,2,4
2585,s1914651220,1914651220,비비헤어,1,1,2,4
2586,s31592363,31592363,나풀,1,1,2,4
2587,s1696066223,1696066223,율쌀롱,1,1,2,4
2588,s1023554377,1023554377,리소헤어 고대점,1,1,2,4
2589,s36905715,36905715,샤샤wave,1,1,2,4
2590,s1112816028,1112816028,륀느헤어,1,1,2,4
2591,s472553980,472553980,슈비스타헤어,1,1,2,4
2592,s37253770,37253770,제미르시앙 헤어,1,1,2,4
2593,s11709824,11709824,이영미 헤어,1,1,2,4
2594,s32565655,32565655,제이앤헤어,1,1,2,4
2595,s1092511875,1092511875,탐스런헤어 압구정점,1,1,2,4
2596,s1270883142,1270883142,헤어바이감성,1,1,2,4
2597,s512074402,512074402,바닐랄라헤어 2호점,1,1,2,4
2598,s13153079,13153079,가위손미용실,1,1,2,4
2599,s1005799081,1005799081,지노헤어 숙대3호점,1,1,2,4
2600,s1237231963,1237231963,모노1208 HAIR,1,1,2,4
2601,s1134554376,1134554376,수 헤어,1,1,2,4
2602,s37373519,37373519,수람헤어,1,1,2,4
2603,s32872904,32872904,앤드 스토리,1,1,2,4
2604,s31401543,31401543,헤어살롱윤슬,2,1,1,4
2605,s41823966,41823966,친절한지균씨,2,1,1,4
2606,s248343559,248343559,h샵,2,1,1,4
2607,s13155081,13155081,이종원헤어콜렉션,1,1,2,4
2608,s38495007,38495007,헤어바이민,2,1,1,4
2609,s36684464,36684464,가빈헤어,1,1,2,4
2610,s1155919644,1155919644,헤어 룩스,2,1,1,4
2611,s33972145,33972145,아가페헤어,1,1,2,4
2612,s36091089,36091089,살롱160,1,1,2,4
2613,s1387499031,1387499031,바나나미용실,1,1,2,4
2614,s1011821824,1011821824,라우라헤어살롱,2,1,1,4
2615,s1953117005,1953117005,아담살롱,1,2,1,4
2616,s1437922140,1437922140,로디헤어,1,1,2,4
2617,s677906097,677906097,서경대 더뷰티샵 블랙,1,1,2,4
2618,s1322030031,1322030031,러버블헤어,1,1,2,4
2619,s37107662,37107662,크레이지wc,1,1,2,4
2620,s38753146,38753146,민 헤어,1,1,2,4
2621,s1525478711,1525478711,헤어사파리,1,1,2,4
2622,s1669936951,1669936951,9hair,2,1,1,4
2623,s1920306491,1920306491,오브앤디유,1,1,2,4
2624,s1607215118,1607215118,미용실입니다,2,1,1,4
2625,s1290557183,1290557183,회기살롱,1,1,2,4
2626,s1063207230,1063207230,샴푸스토리,2,1,1,4
2627,s1847848944,1847848944,헤어메디컬팀,1,1,2,4
2628,s80386611,80386611,오늘헤어,2,1,1,4
2629,s1532281033,1532281033,주주헤어,1,1,2,4
2630,s13399624,13399624,수인헤어,2,1,1,4
2631,s1228484808,1228484808,살롱드 헤어1983,1,1,2,4
2632,s37875731,37875731,온붙임머리,1,1,2,4
2633,s37385995,37385995,미소헤어,1,1,2,4
2634,s35136199,35136199,자이헤어,1,1,2,4
2635,s412456364,412456364,109헤어,1,2,1,4
2636,s1396611509,1396611509,감동헤어,2,1,1,4
2637,s110668297,110668297,단헤어팀,1,1,2,4
2638,s20852762,20852762,머리짱헤어샵,1,2,1,4
2639,s1210134087,1210134087,미니샵,1,2,1,4
2640,s1146979626,1146979626,헤어 푸르지오,1,1,2,4
2641,s1099892263,1099892263,인간미헤어,1,1,2,4
2642,s31055153,31055153,헤어by연,1,1,2,4
2643,s1591873820,1591873820,제이플붙임머리,1,1,2,4
2644,s21125387,21125387,By하루헤어 성산본점,1,1,2,4
2645,s859557468,859557468,Salon de S AURA,1,1,2,4
2646,s12954483,12954483,헤어에스,1,2,1,4
2647,s1239878934,1239878934,다연뷰티룸,2,1,1,4
2648,s34795802,34795802,벨라헤어,1,1,2,4
2649,s1247566089,1247566089,마마살롱,1,1,2,4
2650,s1739882972,1739882972,헤어스튜디오L,2,1,1,4
2651,s66119700,66119700,라엘리,1,1,2,4
2652,s20877189,20877189,조희헤어,1,1,2,4
2653,s1663777265,1663777265,아르테헤어,2,1,1,4
2654,s1139464027,1139464027,헤어코코,1,1,2,4
2655,s30976186,30976186,살롱프리즘,1,1,2,4
2656,s1809593337,1809593337,라크헤어,1,1,2,4
2657,s308573246,308573246,유니헤어공감,1,1,2,4
2658,s36170954,36170954,루시헤어,1,1,2,4
2659,s1359371429,1359371429,다미헤어,1,1,2,4
2660,s1130331912,1130331912,청담언니,2,1,1,4
2661,s1651983598,1651983598,헤어라고,1,1,2,4
2662,s20054648,20054648,주희헤어스케치,1,1,2,4
2663,s11833019,11833019,나건아헤어,1,1,2,4
2664,s1611880803,1611880803,루미넬로,2,1,1,4
2665,s1575210640,1575210640,아카헤어,1,1,2,4
2666,s1006758260,1006758260,와우헤어,1,1,2,4
2667,s37069925,37069925,헤어광,2,1,1,4
2668,s35788140,35788140,라온헤어,1,1,2,4
2669,s38257322,38257322,바바헤어 대치점,1,1,2,4
2670,s760780485,760780485,Amo hair,1,1,2,4
2671,s1676880406,1676880406,다원헤어SALON,2,1,1,4
2672,s1132999245,1132999245,하이살롱,1,1,2,4
2673,s1339132351,1339132351,이리데센트,2,1,1,4
2674,s37234316,37234316,초이헤어,1,1,2,4
2675,s1656819391,1656819391,혜민살롱,2,1,1,4
2676,s38486016,38486016,허벌팔레트 헤어살롱,1,1,2,4
2677,s1140979227,1140979227,2clore,1,1,2,4
2678,s37202888,37202888,사틴헤어 대치점,1,1,2,4
2679,s1917865107,1917865107,샵890헤어살롱,2,1,1,4
2680,s874050067,874050067,누보,1,1,2,4
2681,s36529410,36529410,슈가헤어 신정점,1,1,2,4
2682,s37648318,37648318,블랑드헤어,1,1,2,4
2683,s37204580,37204580,덕수미장원,1,1,2,4
2684,s1891468997,1891468997,제이엠스타헤어,2,1,1,4
2685,s439536786,439536786,엘헤어,1,1,2,4
2686,s1577646863,1577646863,나이스가이 마곡나루역점,1,1,2,4
2687,s36724598,36724598,메종드ic,1,1,2,4
2688,s1272098327,1272098327,늘봄헤어,2,1,1,4
2689,s1828869654,1828869654,청춘미장원,1,1,2,4
2690,s1235411105,1235411105,가희헤어,1,1,2,4
2691,s35125623,35125623,에이투,1,1,2,4
2692,s1748655261,1748655261,더트레스샵,1,1,2,4
2693,s38265198,38265198,리안헤어 위례신도시점,1,1,2,4
2694,s340220137,340220137,언커먼 헤어,1,1,2,4
2695,s1139391011,1139391011,이혁헤어아뜰리에,1,1,2,4
2696,s32610506,32610506,2H헤어,1,1,2,4
2697,s316248484,316248484,이훈ALL30000 이수점,2,1,1,4
2698,s36782182,36782182,조아hair,1,1,2,4
2699,s1323240670,1323240670,피어난헤어,1,1,2,4
2700,s1628517823,1628517823,바바헤어미아점,1,1,2,4
2701,s21856500,21856500,한스헤어 성신여대점,1,1,2,4
2702,s1808967027,1808967027,B HAIR SHOP,1,1,2,4
2703,s1031744868,1031744868,리베르슈에뜨,2,1,1,4
2704,s34079591,34079591,에덴헤어,1,1,2,4
2705,s33068484,33068484,루시헤어,1,1,2,4
2706,s1877875494,1877875494,민헤어,1,1,2,4
2707,s1439350620,1439350620,ZOOT미용실,1,1,2,4
2708,s675438206,675438206,더아트헤어,2,1,1,4
2709,s37402576,37402576,한비헤어,1,1,2,4
2710,s1575858178,1575858178,라이프헤어,2,1,1,4
2711,s1009308710,1009308710,하만살롱,1,1,2,4
2712,s1655198684,1655198684,헤어리베,2,1,1,4
2713,s37531879,37531879,루시르헤어,2,1,1,4
2714,s516638492,516638492,이훈ALL30000 구로디지털본점,1,2,1,4
2715,s20822092,20822092,까까머리방,1,1,2,4
2716,s33292430,33292430,H STYLE헤어살롱 오목교점,2,1,1,4
2717,s36046494,36046494,까사델헤어,1,1,2,4
2718,s1524955179,1524955179,이문원헤어랩,1,1,2,4
2719,s1801253768,1801253768,촉촉헤어,1,1,2,4
2720,s34345058,34345058,블레스바버샵,1,1,2,4
2721,s38289486,38289486,시너지헤어,1,1,2,4
2722,s37820315,37820315,블룸 헤어,1,1,2,4
2723,s20618124,20618124,자이헤어,1,1,2,4
2724,s35142793,35142793,빛나헤어아트,2,1,1,4
2725,s38696036,38696036,라보떼헤어,1,1,2,4
2726,s18236026,18236026,이정애헤어뷰티펌,1,1,1,3
2727,s1170267555,1170267555,허쌤헤어스튜디오,1,1,1,3
2728,s19449171,19449171,세븐,1,1,1,3
2729,s18887780,18887780,대우미용실,1,1,1,3
2730,s18222720,18222720,드림헤어,1,1,1,3
2731,s18889528,18889528,리나미용실,1,1,1,3
2732,s1722072650,1722072650,이레미용실,1,1,1,3
2733,s1564566238,1564566238,오테르,1,1,1,3
2734,s18556583,18556583,머리삔&드림라인미용학원,1,1,1,3
2735,s20862013,20862013,헤어토크,1,1,1,3
2736,s1111757517,1111757517,쵸이스미용실,1,1,1,3
2737,s1559433320,1559433320,크로스헤어,1,1,1,3
2738,s18862440,18862440,이성민헤어샵,1,1,1,3
2739,s1195017779,1195017779,필헤어,1,1,1,3
2740,s37322733,37322733,앙포레모리노헤어 신천점,1,1,1,3
2741,s1965280310,1965280310,루밍헤어,1,1,1,3
2742,s21849358,21849358,헤어모드,1,1,1,3
2743,s18924101,18924101,준헤어라인,1,1,1,3
2744,s11568331,11568331,도도헤어보그,1,1,1,3
2745,s1100804901,1100804901,미가미장미용실,1,1,1,3
2746,s1724636231,1724636231,강희헤어클럽,1,1,1,3
2747,s20827876,20827876,김민정헤어갤러리,1,1,1,3
2748,s20862674,20862674,장헤어존,1,1,1,3
2749,s37525729,37525729,102헤어,1,1,1,3
2750,s57634710,57634710,착한머리,1,1,1,3
2751,s691044566,691044566,머리하는날,1,1,1,3
2752,s13151160,13151160,지노송헤어,1,1,1,3
2753,s1767976019,1767976019,준헤어스케치,1,1,1,3
2754,s1710580295,1710580295,아지트미용실,1,1,1,3
2755,s20637278,20637278,마리헤어,1,1,1,3
2756,s37430155,37430155,보떼헤어,1,1,1,3
2757,s1851916503,1851916503,퍼플헤어,1,1,1,3
2758,s1798120921,1798120921,리브가미용실,1,1,1,3
2759,s20832044,20832044,더스타일헤어존,1,1,1,3
2760,s21362078,21362078,본연애헤어 신내점,1,1,1,3
2761,s20834696,20834696,지노헤어클럽,1,1,1,3
2762,s1817543836,1817543836,채경헤어,1,1,1,3
2763,s19882692,19882692,준헤어,1,1,1,3
2764,s1247561111,1247561111,시크헤어,1,1,1,3
2765,s1237665649,1237665649,강헤어,1,1,1,3
2766,s1359158599,1359158599,최연재미용실,1,1,1,3
2767,s20856445,20856445,박성덕헤어샵마천본점,1,1,1,3
2768,s20866779,20866779,김민헤어드레서,1,1,1,3
2769,s20904108,20904108,JJ프로헤어,1,1,1,3
2770,s20927874,20927874,순헤어샵,1,1,1,3
2771,s1055827298,1055827298,호수헤어,1,1,1,3
2772,s20854325,20854325,띠앗머리,1,1,1,3
2773,s800540229,800540229,단골미용실,1,1,1,3
2774,s38673846,38673846,바라봄헤어살롱,1,1,1,3
2775,s20052329,20052329,끌레오헤어,1,1,1,3
2776,s32093888,32093888,민호헤어피카소,1,1,1,3
2777,s1018956516,1018956516,자르헤어,1,1,1,3
2778,s18901264,18901264,고은미용실,1,1,1,3
2779,s20835665,20835665,예림헤어,1,1,1,3
2780,s20843670,20843670,더블유헤어,1,1,1,3
2781,s20837351,20837351,미키헤어타운,1,1,1,3
2782,s20885045,20885045,배추머리 면목점,1,1,1,3
2783,s1199682176,1199682176,이종은헤어,1,1,1,3
2784,s1290740134,1290740134,숙헤어샵,1,1,1,3
2785,s20897455,20897455,클로에헤어샵,1,1,1,3
2786,s1433642067,1433642067,더 힐즈 헤어룸,1,1,1,3
2787,s1081745386,1081745386,정헤어,1,1,1,3
2788,s18875427,18875427,센스헤어클럽,1,1,1,3
2789,s1712462525,1712462525,헤어스타일,1,1,1,3
2790,s35092445,35092445,지민헤어,1,1,1,3
2791,s20866619,20866619,엘리헤어,1,1,1,3
2792,s20858101,20858101,시선헤어,1,1,1,3
2793,s20905093,20905093,롯데헤어,1,1,1,3
2794,s1370336267,1370336267,미&미헤어,1,1,1,3
2795,s18890905,18890905,민정헤어필,1,1,1,3
2796,s18273564,18273564,이지스헤어 강북점,1,1,1,3
2797,s20854327,20854327,란헤어살롱,1,1,1,3
2798,s1661901537,1661901537,미리미리헤어샵,1,1,1,3
2799,s13172431,13172431,젬스헤어,1,1,1,3
2800,s20827099,20827099,강헤어콜렉션,1,1,1,3
2801,s37341848,37341848,노현정헤어,1,1,1,3
2802,s1600856793,1600856793,노현정헤어아트,1,1,1,3
2803,s18248990,18248990,까까보까,1,1,1,3
2804,s1103230101,1103230101,정연숙헤어,1,1,1,3
2805,s18864574,18864574,송헤어아트,1,1,1,3
2806,s1525085994,1525085994,카리스헤어,1,1,1,3
2807,s20893497,20893497,가위사랑미용실,1,1,1,3
2808,s11701659,11701659,헤어세럼,1,1,1,3
2809,s32779514,32779514,버르장머리,1,1,1,3
2810,s1549283765,1549283765,라피네 헤어샵,1,1,1,3
2811,s20623823,20623823,스타헤어랜드,1,1,1,3
2812,s13442799,13442799,공기헤어,1,1,1,3
2813,s1011244039,1011244039,티는헤어,1,1,1,3
2814,s1408009897,1408009897,하연헤어,1,1,1,3
2815,s13134103,13134103,HAIRBY,1,1,1,3
2816,s20263765,20263765,심가미장,1,1,1,3
2817,s1305873657,1305873657,지앤미헤어,1,1,1,3
2818,s1314373262,1314373262,에바헤어,1,1,1,3
2819,s37089761,37089761,헬로컷,1,1,1,3
2820,s18908125,18908125,모던헤어 정릉본점,1,1,1,3
2821,s18271686,18271686,미다듬헤허휠,1,1,1,3
2822,s77633951,77633951,최귀영헤어방,1,1,1,3
2823,s18912594,18912594,쉼터미용실,1,1,1,3
2824,s124964298,124964298,한스헤어,1,1,1,3
2825,s1483931598,1483931598,실버스타미용실,1,1,1,3
2826,s20637150,20637150,경희뷰티헤어,1,1,1,3
2827,s20870554,20870554,J&Y헤어갤러리,1,1,1,3
2828,s699399182,699399182,예작헤어라인,1,1,1,3
2829,s1366164109,1366164109,신광미용실,1,1,1,3
2830,s20936792,20936792,박경숙미용실,1,1,1,3
2831,s21646232,21646232,채연헤어샵,1,1,1,3
2832,s1169494943,1169494943,사쿠토헤어,1,1,1,3
2833,s34349631,34349631,헤어맘,1,1,1,3
2834,s20823784,20823784,헤어야,1,1,1,3
2835,s38291581,38291581,까까머리,1,1,1,3
2836,s33706875,33706875,신데렐라헤어,1,1,1,3
2837,s1095244321,1095244321,헤어박,1,1,1,3
2838,s1843103539,1843103539,루디아헤어,1,1,1,3
2839,s18917394,18917394,라이징헤어,1,1,1,3
2840,s18853005,18853005,리즈헤어,1,1,1,3
2841,s1087441643,1087441643,다온헤어,1,1,1,3
2842,s951934976,951934976,텔리헤어,1,1,1,3
2843,s37811885,37811885,문서연헤어,1,1,1,3
2844,s18883623,18883623,모모머리나라,1,1,1,3
2845,s18322463,18322463,충남미용실,1,1,1,3
2846,s20830639,20830639,이영헤어아트,1,1,1,3
2847,s36833261,36833261,오앤살롱,1,1,1,3
2848,s36175115,36175115,시크릿by강현헤어살롱,1,1,1,3
2849,s33705110,33705110,마잘헤어,1,1,1,3
2850,s1188867361,1188867361,애니헤어,1,1,1,3
2851,s20834872,20834872,쉬즈헤어,1,1,1,3
2852,s1211561325,1211561325,코코미용실,1,1,1,3
2853,s1590090053,1590090053,헤어도로시,1,1,1,3
2854,s20858121,20858121,헤어스케치,1,1,1,3
2855,s1033873502,1033873502,온the헤어,1,1,1,3
2856,s1282081380,1282081380,최미희헤어샵,1,1,1,3
2857,s36271053,36271053,서정화헤어살롱,1,1,1,3
2858,s1929746417,1929746417,마리헤어,1,1,1,3
2859,s20870542,20870542,현주머리마을,1,1,1,3
2860,s13296946,13296946,황정옥미용실,1,1,1,3
2861,s19994174,19994174,테스펌헤어살롱,1,1,1,3
2862,s32093920,32093920,인프로헤어,1,1,1,3
2863,s1090979369,1090979369,재희미용실,1,1,1,3
2864,s20847642,20847642,연희미용실,1,1,1,3
2865,s18248972,18248972,헤어센스,1,1,1,3
2866,s20923984,20923984,아게라미용실,1,1,1,3
2867,s20923958,20923958,상록수헤어방,1,1,1,3
2868,s20912439,20912439,헤어메카,1,1,1,3
2869,s1183610882,1183610882,닛시헤어샵,1,1,1,3
2870,s1268981058,1268981058,행운미용실,1,1,1,3
2871,s1744800678,1744800678,까까머리방 헤어샵,1,1,1,3
2872,s1111377204,1111377204,참머리사랑,1,1,1,3
2873,s36453988,36453988,헤어랑뷰,1,1,1,3
2874,s1317370879,1317370879,현대미용실,1,1,1,3
2875,s20923967,20923967,머리하는날,1,1,1,3
2876,s18916844,18916844,황지헤어일번지,1,1,1,3
2877,s20821459,20821459,레나김헤어샵,1,1,1,3
2878,s567440121,567440121,최승희헤어,1,1,1,3
2879,s20872032,20872032,죠이헤어마당,1,1,1,3
2880,s18912977,18912977,윤희미용실,1,1,1,3
2881,s20931766,20931766,샤론,1,1,1,3
2882,s35807390,35807390,줌마헤어,1,1,1,3
2883,s1288694782,1288694782,정화미용실,1,1,1,3
2884,s32094507,32094507,이찬헤어랜드,1,1,1,3
2885,s35949403,35949403,김정희헤어스케치,1,1,1,3
2886,s20839726,20839726,사랑미용실,1,1,1,3
2887,s1036284907,1036284907,살롱드리,1,1,1,3
2888,s18316437,18316437,올리브헤어컷,1,1,1,3
2889,s1013563803,1013563803,라인헤어,1,1,1,3
2890,s1193121817,1193121817,정혜원미용실,1,1,1,3
2891,s18904776,18904776,새시대미용실,1,1,1,3
2892,s36005256,36005256,영풍이발관,1,1,1,3
2893,s20847618,20847618,은헤미용실,1,1,1,3
2894,s18470742,18470742,아름머리방,1,1,1,3
2895,s1084521922,1084521922,퀸즈헤나염색방 잠실역점,1,1,1,3
2896,s34354001,34354001,오랜지헤어필,1,1,1,3
2897,s20862791,20862791,머리카락컬렉션,1,1,1,3
2898,s20835680,20835680,진미용실,1,1,1,3
2899,s20889624,20889624,희원미용실,1,1,1,3
2900,s19882702,19882702,Jk헤어,1,1,1,3
2901,s18486275,18486275,우정미용실,1,1,1,3
2902,s1746942129,1746942129,영헤어아트,1,1,1,3
2903,s18227402,18227402,양미용실,1,1,1,3
2904,s20889744,20889744,라인헤어프라자,1,1,1,3
2905,s117645529,117645529,샤론미용실,1,1,1,3
2906,s1506154953,1506154953,헤라미용실,1,1,1,3
2907,s1288295657,1288295657,D헤어살롱,1,1,1,3
2908,s13158893,13158893,아마빌레,1,1,1,3
2909,s34353488,34353488,남정임헤어,1,1,1,3
2910,s20920068,20920068,김선경헤어아트,1,1,1,3
2911,s20862912,20862912,영헤어,1,1,1,3
2912,s11611512,11611512,엔아베뷰티살롱,1,1,1,3
2913,s20931572,20931572,가이헤어클럽,1,1,1,3
2914,s19414403,19414403,고파슈헤어,1,1,1,3
2915,s1410435554,1410435554,사라미용실,1,1,1,3
2916,s18890768,18890768,에덴미용실,1,1,1,3
2917,s587738684,587738684,우미헤어타운,1,1,1,3
2918,s1514629999,1514629999,샤갈헤어스토리본점,1,1,1,3
2919,s20851268,20851268,유니헤어클럽,1,1,1,3
2920,s1921577645,1921577645,재희미용실,1,1,1,3
2921,s79361110,79361110,오디션헤어,1,1,1,3
2922,s18486288,18486288,미인헤어,1,1,1,3
2923,s20885053,20885053,김승희헤어,1,1,1,3
2924,s20862911,20862911,한헤어,1,1,1,3
2925,s49552555,49552555,청운헤어,1,1,1,3
2926,s11730157,11730157,블루클럽 오금역점,1,1,1,3
2927,s1043197260,1043197260,이뿐머리,1,1,1,3
2928,s1052630042,1052630042,비비드컬러,1,1,1,3
2929,s1688098576,1688098576,가위랑나랑미용실,1,1,1,3
2930,s18919056,18919056,진미용실,1,1,1,3
2931,s20931610,20931610,스칼렛미용실,1,1,1,3
2932,s36669216,36669216,카라헤어,1,1,1,3
2933,s37941492,37941492,더헤어,1,1,1,3
2934,s1170482342,1170482342,이순례헤어샾,1,1,1,3
2935,s18319197,18319197,차지혜미용실,1,1,1,3
2936,s11634636,11634636,머리이야기,1,1,1,3
2937,s93982375,93982375,ES헤어,1,1,1,3
2938,s18470839,18470839,영헤어라인,1,1,1,3
2939,s20855039,20855039,JS헤어,1,1,1,3
2940,s1757957463,1757957463,공주미용실,1,1,1,3
2941,s18507310,18507310,조시아헤어메이에르,1,1,1,3
2942,s20889859,20889859,장혜영가위소리,1,1,1,3
2943,s205956995,205956995,퀸즈헤어 송파풍납점,1,1,1,3
2944,s36924532,36924532,미전들헤어,1,1,1,3
2945,s1292193195,1292193195,한샘남자머리,1,1,1,3
2946,s20892821,20892821,권지은헤어스케치,1,1,1,3
2947,s1154284496,1154284496,아람헤어,1,1,1,3
2948,s18322458,18322458,석화미용실,1,1,1,3
2949,s1628286184,1628286184,헤어끌레오,1,1,1,3
2950,s18912264,18912264,다인헤어라인,1,1,1,3
2951,s18541190,18541190,빗과가위소리,1,1,1,3
2952,s20832057,20832057,동신미용실,1,1,1,3
2953,s1965755875,1965755875,글로벌헤어,1,1,1,3
2954,s355161730,355161730,개성연출,1,1,1,3
2955,s20875701,20875701,미그리고센스미용실,1,1,1,3
2956,s45594356,45594356,추봉재헤어아리아,1,1,1,3
2957,s12995570,12995570,에스더헤어,1,1,1,3
2958,s556469387,556469387,정민프로헤어미용실,1,1,1,3
2959,s555948951,555948951,킴스헤어클럽,1,1,1,3
2960,s1054291683,1054291683,박미용실,1,1,1,3
2961,s585920824,585920824,오월헤어,1,1,1,3
2962,s20827983,20827983,머리자를래,1,1,1,3
2963,s20920095,20920095,토토헤어,1,1,1,3
2964,s33481602,33481602,피어리스미카,1,1,1,3
2965,s1283373404,1283373404,김선희헤어모드,1,1,1,3
2966,s1406592660,1406592660,우리미용실,1,1,1,3
2967,sk301471863,k301471863,새범뷰티,1,1,1,3
2968,s20940648,20940648,솔헤어라인,1,1,1,3
2969,s266639792,266639792,김선희헤어모드,1,1,1,3
2970,s34403715,34403715,은혜헤어플러스,1,1,1,3
2971,s21787795,21787795,루디아헤어,1,1,1,3
2972,s1890227501,1890227501,다모아미용실,1,1,1,3
2973,s18882406,18882406,단발의집,1,1,1,3
2974,s32105068,32105068,빨강댕기미용실,1,1,1,3
2975,s18540148,18540148,변가헤어드레서,1,1,1,3
2976,s1244423023,1244423023,윤헤어,1,1,1,3
2977,s20931523,20931523,솔로헤어,1,1,1,3
2978,s1137296311,1137296311,모리헤어,1,1,1,3
2979,s20834754,20834754,윤헤어샵,1,1,1,3
2980,s20860310,20860310,유혜지헤어,1,1,1,3
2981,s20878209,20878209,이남헤어아트,1,1,1,3
2982,s18271517,18271517,자매미장원,1,1,1,3
2983,s1169167288,1169167288,크라크라헤어클럽,1,1,1,3
2984,s20632306,20632306,빨강머리앤,1,1,1,3
2985,s1857497342,1857497342,헬로우컷 잠실신천점,1,1,1,3
2986,s32104353,32104353,지나펌,1,1,1,3
2987,s18453335,18453335,양미용실,1,1,1,3
2988,s20939302,20939302,로얄헤어샵,1,1,1,3
2989,s34309120,34309120,리스헤어,1,1,1,3
2990,s18910930,18910930,퀸헤어센스,1,1,1,3
2991,s1408208264,1408208264,헤어스크린,1,1,1,3
2992,s35444830,35444830,블루클럽 월곡점,1,1,1,3
2993,s1900194437,1900194437,아띠헤어,1,1,1,3
2994,s1684983915,1684983915,헤어모드,1,1,1,3
2995,s20272218,20272218,블루클럽 길음역점,1,1,1,3
2996,s18865531,18865531,비헤어드레싱,1,1,1,3
2997,s20862073,20862073,머리쟁이,1,1,1,3
2998,s18557874,18557874,영헤어코코,1,1,1,3
2999,s18459231,18459231,소미샾,1,1,1,3
3000,s1620392773,1620392773,아프로디테헤어,1,1,1,3
3001,s18853679,18853679,퀸헤어클릭,1,1,1,3
3002,s20622854,20622854,끼머리방,1,1,1,3
3003,s584200802,584200802,하나헤어,1,1,1,3
3004,s1455907466,1455907466,컷트이야기,1,1,1,3
3005,s18851461,18851461,까미헤어,1,1,1,3
3006,s1692578731,1692578731,브니엘헤어 장위점,1,1,1,3
3007,s18545234,18545234,칼라헤어센스,1,1,1,3
3008,s1264950796,1264950796,가브리엘헤어샵,1,1,1,3
3009,s1535123174,1535123174,까까머리,1,1,1,3
3010,s31825045,31825045,김민정헤어스테이션,1,1,1,3
3011,s18904907,18904907,박미정헤어센스,1,1,1,3
3012,s20843621,20843621,오수현머리방,1,1,1,3
3013,s18461565,18461565,아름다운그녀,1,1,1,3
3014,s1667698587,1667698587,여름엔컷겨울엔펌,1,1,1,3
3015,s19418528,19418528,나옥진헤어샵,1,1,1,3
3016,s1412111433,1412111433,류지연미용실,1,1,1,3
3017,s20868267,20868267,퀸미용실,1,1,1,3
3018,s20625446,20625446,설헤어아트,1,1,1,3
3019,s18853016,18853016,개성시대,1,1,1,3
3020,s18916311,18916311,2박스헤어,1,1,1,3
3021,s1248623578,1248623578,좋은이웃헤어터치,1,1,1,3
3022,s1103252884,1103252884,코코미용실,1,1,1,3
3023,s1382302266,1382302266,연희미용실,1,1,1,3
3024,s20878442,20878442,가위소리미용실,1,1,1,3
3025,s31121660,31121660,쉬크헤어,1,1,1,3
3026,s18868732,18868732,노블레스헤어샵,1,1,1,3
3027,s38734161,38734161,김선숙머리스케치,1,1,1,3
3028,s32087764,32087764,수헤어살롱,1,1,1,3
3029,s37310957,37310957,아모스헤어,1,1,1,3
3030,s1891254254,1891254254,나경미용실,1,1,1,3
3031,s18897001,18897001,해리헤어,1,1,1,3
3032,s38554413,38554413,까그리헤어 맞춤가발,1,1,1,3
3033,s32302489,32302489,한윤경미용실,1,1,1,3
3034,s34349627,34349627,하니헤어클럽,1,1,1,3
3035,s1503656725,1503656725,제이헤어,1,1,1,3
3036,s1473802220,1473802220,김희숙헤어,1,1,1,3
3037,s18845372,18845372,시넬헤어샵,1,1,1,3
3038,s20628634,20628634,O2헤어갤러리,1,1,1,3
3039,s1049933189,1049933189,작품하나미용실,1,1,1,3
3040,s623618882,623618882,헤어컬 두,1,1,1,3
3041,s20939337,20939337,서영옥헤어케치,1,1,1,3
3042,s11728658,11728658,최가을 헤어드레서 돈암점,1,1,1,3
3043,s20939304,20939304,엘림헤어리더,1,1,1,3
3044,s1639343022,1639343022,옥낭헤어샵,1,1,1,3
3045,s20828083,20828083,토브헤어,1,1,1,3
3046,s312817342,312817342,이준우미용실,1,1,1,3
3047,s20893685,20893685,웨딩과헤어샵,1,1,1,3
3048,s18453327,18453327,나성미용실,1,1,1,3
3049,s1385063629,1385063629,이지오프로헤어,1,1,1,3
3050,s18453368,18453368,다나헤어살롱,1,1,1,3
3051,s18905537,18905537,성원머리방,1,1,1,3
3052,s1861203742,1861203742,헬로펌헤어살롱 망우점,1,1,1,3
3053,s1463632051,1463632051,이상미용실,1,1,1,3
3054,s37699944,37699944,하포스트헤어샵,1,1,1,3
3055,s19362264,19362264,고운머리,1,1,1,3
3056,s20978259,20978259,오로디헤어샾,1,1,1,3
3057,s1572506678,1572506678,미그린미용실,1,1,1,3
3058,s1632471513,1632471513,루비오미용실,1,1,1,3
3059,s1617178014,1617178014,살롱오데뜨,1,1,1,3
3060,s1276292570,1276292570,수지헤어,1,1,1,3
3061,s37803848,37803848,이훈헤어칼라 송파점,1,1,1,3
3062,s1797671534,1797671534,이쁘다헤어샵,1,1,1,3
3063,s1970095373,1970095373,조정애헤어,1,1,1,3
3064,s37188889,37188889,헤어살롱리,1,1,1,3
3065,s36005277,36005277,차밍미용실,1,1,1,3
3066,s1563476190,1563476190,토리헤어 미아사거리점,1,1,1,3
3067,s33261728,33261728,슈퍼스타헤어 1호점,1,1,1,3
3068,s1991250421,1991250421,지니헤어,1,1,1,3
3069,s18495535,18495535,에덴미용실,1,1,1,3
3070,s1709718578,1709718578,오미헤어,1,1,1,3
3071,s1097466570,1097466570,ECLAT HAIR,1,1,1,3
3072,s18859639,18859639,더헤어,1,1,1,3
3073,s1760257193,1760257193,헬로우컷 송파헬리오시티점,1,1,1,3
3074,s1183533792,1183533792,맥소통쑥사랑,1,1,1,3
3075,s1447486956,1447486956,예쁘다헤어,1,1,1,3
3076,s20877263,20877263,위드헤어,1,1,1,3
3077,s18871138,18871138,가위손,1,1,1,3
3078,s1230861837,1230861837,옻안타는천연염색,1,1,1,3
3079,s1557745535,1557745535,헤어블로그,1,1,1,3
3080,s18556578,18556578,류킴스,1,1,1,3
3081,s18848141,18848141,CC헤어클럽,1,1,1,3
3082,s414111906,414111906,택시헤어,1,1,1,3
3083,s20845176,20845176,모던헤어,1,1,1,3
3084,s1344302447,1344302447,헤어카페,1,1,1,3
3085,s20934571,20934571,희헤어센스,1,1,1,3
3086,s1658363250,1658363250,하나헤어,1,1,1,3
3087,s18133465,18133465,로데오미용실,1,1,1,3
3088,s36924729,36924729,헤어스토리,1,1,1,3
3089,s1709170294,1709170294,궁헤어,1,1,1,3
3090,s1078378826,1078378826,웰컴헤어,1,1,1,3
3091,s18888536,18888536,정현정머리방,1,1,1,3
3092,s1376584332,1376584332,TK헤어,1,1,1,3
3093,s18506954,18506954,서정아헤어컬렉션,1,1,1,3
3094,s1017844574,1017844574,염색편의점 삼선교직영점,1,1,1,3
3095,s20831141,20831141,가위와빗,1,1,1,3
3096,s1651100643,1651100643,홀리헤어스튜디오,1,1,1,3
3097,s20917834,20917834,김복남헤어장,1,1,1,3
3098,s1687000922,1687000922,아셀헤어,1,1,1,3
3099,s1222495209,1222495209,김씨네미용실,1,1,1,3
3100,s1862013937,1862013937,말자헤어살롱,1,1,1,3
3101,s1727318397,1727318397,필래뽀끌래,1,1,1,3
3102,s1114763637,1114763637,뜨랑민경,1,1,1,3
3103,s1255677834,1255677834,에이치앤와이헤어샵,1,1,1,3
3104,s20904021,20904021,예은헤어짱,1,1,1,3
3105,s20896543,20896543,헤어유,1,1,1,3
3106,s34015934,34015934,s스칼렛헤어,1,1,1,3
3107,s1136020210,1136020210,메시헤어,1,1,1,3
3108,s1178580133,1178580133,K HAIR,1,1,1,3
3109,s13151778,13151778,에벤에셀미용실,1,1,1,3
3110,s20910373,20910373,챠밍미용실,1,1,1,3
3111,s19458897,19458897,제이헤어,1,1,1,3
3112,s20879684,20879684,헤어매니아,1,1,1,3
3113,s1503748971,1503748971,헤어케이,1,1,1,3
3114,s20838626,20838626,쎄븐미용실,1,1,1,3
3115,s1472226148,1472226148,헬리오헤어,1,1,1,3
3116,s767118050,767118050,아롱살롱,1,1,1,3
3117,s1237772438,1237772438,면목 파마헤어,1,1,1,3
3118,s1961361101,1961361101,미코헤어,1,1,1,3
3119,s20630152,20630152,헤어클럽마지아,1,1,1,3
3120,s20877482,20877482,폴헤어센스,1,1,1,3
3121,s1001840131,1001840131,태후사랑 정릉점,1,1,1,3
3122,s18904398,18904398,은하헤어아트,1,1,1,3
3123,s1131290596,1131290596,최가헤어살롱드,1,1,1,3
3124,s13159599,13159599,맨투맨남성미용실,1,1,1,3
3125,s20925421,20925421,댕기머리,1,1,1,3
3126,s1633560521,1633560521,나이스가이 잠실트리지움점,1,1,1,3
3127,s18486279,18486279,우리들머리방,1,1,1,3
3128,s18898644,18898644,박민제머리방,1,1,1,3
3129,s555199064,555199064,스타헤어,1,1,1,3
3130,s1713248378,1713248378,아름헤어,1,1,1,3
3131,s11730135,11730135,블루클럽 방이시장점,1,1,1,3
3132,s1092977020,1092977020,두잇헤어,1,1,1,3
3133,s18570471,18570471,김영애댕기머리,1,1,1,3
3134,s1217010965,1217010965,놀이터쌀롱,1,1,1,3
3135,s18508271,18508271,보떼헤어샵,1,1,1,3
3136,s1001498750,1001498750,헤어터치,1,1,1,3
3137,s38737053,38737053,유란헤어,1,1,1,3
3138,s316051867,316051867,헤나킹 석계점,1,1,1,3
3139,s1459204331,1459204331,릴리헤어,1,1,1,3
3140,s38350267,38350267,오지선미용실,1,1,1,3
3141,s1942078186,1942078186,샬롬헤어샵,1,1,1,3
3142,s1219332137,1219332137,마르떼헤어,1,1,1,3
3143,s32094913,32094913,머리해요 본점,1,1,1,3
3144,s18573256,18573256,임세미헤어라인,1,1,1,3
3145,s20916309,20916309,까까머리,1,1,1,3
3146,s597962926,597962926,블루문 헤어,1,1,1,3
3147,s1186408274,1186408274,린헤어,1,1,1,3
3148,s1074709039,1074709039,제이헤어,1,1,1,3
3149,s1241880450,1241880450,다원헤어,1,1,1,3
3150,s1539255273,1539255273,하다헤어,1,1,1,3
3151,s20641982,20641982,김선자미용실,1,1,1,3
3152,s1356679207,1356679207,은빈헤어,1,1,1,3
3153,s18518561,18518561,국제헤어,1,1,1,3
3154,s38557677,38557677,나이스가이 잠실새내점,1,1,1,3
3155,s1495212655,1495212655,나이스가이 헬리오시티점,1,1,1,3
3156,s163783017,163783017,라곰헤어스튜디오,1,1,1,3
3157,s1092385386,1092385386,수다싸롱,1,1,1,3
3158,s20915657,20915657,박미용실,1,1,1,3
3159,s20905136,20905136,이원남머리꾼,1,1,1,3
3160,s13415610,13415610,파마20000,1,1,1,3
3161,s1288355886,1288355886,퀸즈헤어,1,1,1,3
3162,s1670828741,1670828741,라파헤어,1,1,1,3
3163,s751552573,751552573,황정해미용실,1,1,1,3
3164,s1201019508,1201019508,요술머리,1,1,1,3
3165,s1705965151,1705965151,헤어스테이,1,1,1,3
3166,s1455146085,1455146085,제일미용실,1,1,1,3
3167,s20881383,20881383,칼라헤어뱅크,1,1,1,3
3168,s1315710973,1315710973,쵸콜릿헤어석관본점,1,1,1,3
3169,s20963074,20963074,아가도스헤어샵,1,1,1,3
3170,s1188755515,1188755515,오후헤어,1,1,1,3
3171,s20838533,20838533,고은헤어샵,1,1,1,3
3172,s1018788584,1018788584,행복한미용실,1,1,1,3
3173,s1433342070,1433342070,요술가위,1,1,1,3
3174,s20860420,20860420,셀바헤어,1,1,1,3
3175,s504224589,504224589,수민헤어,1,1,1,3
3176,s20628436,20628436,최혜선미용실,1,1,1,3
3177,s1168725322,1168725322,헬로우컷 마천점,1,1,1,3
3178,s21547464,21547464,제이제이헤어보고,1,1,1,3
3179,s18568761,18568761,조희미용실,1,1,1,3
3180,s18559520,18559520,리드헤어모드,1,1,1,3
3181,s18891708,18891708,꼭지미용실,1,1,1,3
3182,s38297370,38297370,까끌레뽀끌레,1,1,1,3
3183,s1411350044,1411350044,엘르 미용실,1,1,1,3
3184,s20624468,20624468,헤어매니아,1,1,1,3
3185,s1843367464,1843367464,구피샵 마천점,1,1,1,3
3186,s1603388228,1603388228,이정헤어,1,1,1,3
3187,s1934807106,1934807106,이사미헤어,1,1,1,3
3188,s1982838082,1982838082,명작W헤어,1,1,1,3
3189,s1534071490,1534071490,오티헤어,1,1,1,3
3190,s36033779,36033779,엘헤어,1,1,1,3
3191,s11730133,11730133,블루클럽 마천점,1,1,1,3
3192,s20628480,20628480,헤라미용실,1,1,1,3
3193,s251878603,251878603,승희머리꾼,1,1,1,3
3194,s1227544155,1227544155,헤어코코,1,1,1,3
3195,s38704432,38704432,키 헤어앤 스토어,1,1,1,3
3196,s37673005,37673005,루나헤어,1,1,1,3
3197,s36005278,36005278,이혜경롤앤컷,1,1,1,3
3198,s1756240075,1756240075,권정희헤어퍼퓸,1,1,1,3
3199,s20864401,20864401,원미용실,1,1,1,3
3200,s86924619,86924619,이현주미용실,1,1,1,3
3201,s1032482527,1032482527,오은헤어샵,1,1,1,3
3202,s1253723450,1253723450,미미헤어,1,1,1,3
3203,s20906641,20906641,영헤어샵,1,1,1,3
3204,s1408940111,1408940111,오은헤어&컬링샾,1,1,1,3
3205,s20524872,20524872,강가네미장원,1,1,1,3
3206,s18555956,18555956,송옥녀헤어스케치,1,1,1,3
3207,s1449164521,1449164521,끌리오미용실,1,1,1,3
3208,s1609256223,1609256223,양지헤어,1,1,1,3
3209,s20627665,20627665,개성시대,1,1,1,3
3210,s791128292,791128292,JJ헤어보고,1,1,1,3
3211,s13152920,13152920,소유경헤어샵,1,1,1,3
3212,s1581274096,1581274096,꽃순이네미장원,1,1,1,3
3213,s20627007,20627007,이헤어필,1,1,1,3
3214,s37615392,37615392,더헤어,1,1,1,3
3215,s32489942,32489942,고소연뷰티랩미용실,1,1,1,3
3216,s548671825,548671825,상투머리,1,1,1,3
3217,s959178897,959178897,스잔미용실,1,1,1,3
3218,s899225554,899225554,세실헤어아트,1,1,1,3
3219,s20848771,20848771,목화미용실,1,1,1,3
3220,s13158726,13158726,박춘희헤어샵 석촌점,1,1,1,3
3221,s382754790,382754790,HE헤어,1,1,1,3
3222,s1746861704,1746861704,마샬미용실,1,1,1,3
3223,s18890562,18890562,헤어필,1,1,1,3
3224,s20841175,20841175,유리미용실,1,1,1,3
3225,s20898768,20898768,주희헤어샵,1,1,1,3
3226,s1144959718,1144959718,큐사랑헤어샵,1,1,1,3
3227,s18554916,18554916,챠밍미용실,1,1,1,3
3228,s20898786,20898786,명동헤어센스,1,1,1,3
3229,s1572669411,1572669411,정연정헤어콜렉션,1,1,1,3
3230,s20842754,20842754,하나머리방,1,1,1,3
3231,s20873586,20873586,우리머리방,1,1,1,3
3232,s20919285,20919285,우리미용실,1,1,1,3
3233,s18205831,18205831,SY헤어스케치,1,1,1,3
3234,s1666993877,1666993877,어반헤어,1,1,1,3
3235,s18888542,18888542,지니헤어클럽,1,1,1,3
3236,s37475106,37475106,구피샵 동부시장점,1,1,1,3
3237,s20926912,20926912,머털이헤어아트,1,1,1,3
3238,s622526170,622526170,샤론헤어샵,1,1,1,3
3239,s1752069598,1752069598,블랑헤어,1,1,1,3
3240,s1006340757,1006340757,이즈헤어,1,1,1,3
3241,s20871984,20871984,현지헤어샵,1,1,1,3
3242,s1889333848,1889333848,서희정헤어보그,1,1,1,3
3243,s20934693,20934693,김재희헤어,1,1,1,3
3244,s20624355,20624355,김정실헤어샵,1,1,1,3
3245,s1802626041,1802626041,조은염색,1,1,1,3
3246,s20879887,20879887,도담헤어,1,1,1,3
3247,s20825310,20825310,헤어뜨레,1,1,1,3
3248,s1493770734,1493770734,미장원선,1,1,1,3
3249,s277941949,277941949,백조헤어샾,1,1,1,3
3250,s1955825769,1955825769,에바샵헤어,1,1,1,3
3251,s20894588,20894588,은혜미용실,1,1,1,3
3252,s20860421,20860421,박민헤어샵,1,1,1,3
3253,s20897409,20897409,용숙희헤어뱅크,1,1,1,3
3254,s20933159,20933159,전영숙헤어샵,1,1,1,3
3255,s18550482,18550482,마샬헤어갤러리,1,1,1,3
3256,s13090679,13090679,은이헤어샵,1,1,1,3
3257,s1200506982,1200506982,커트클럽,1,1,1,3
3258,s1769290976,1769290976,또동하우스,1,1,1,3
3259,s20887312,20887312,문미용실,1,1,1,3
3260,s20917871,20917871,지그재그헤어클럽,1,1,1,3
3261,s20627073,20627073,현대미용실,1,1,1,3
3262,s20906560,20906560,이영희헤어매니아,1,1,1,3
3263,s843587074,843587074,진홍헤어샵,1,1,1,3
3264,s13389924,13389924,마리헤어미용실,1,1,1,3
3265,s18871916,18871916,김선미미용실,1,1,1,3
3266,s752734691,752734691,김영숙헤어클럽,1,1,1,3
3267,s38555406,38555406,미남미녀헤어,1,1,1,3
3268,s614557022,614557022,헤어코디,1,1,1,3
3269,s1895548996,1895548996,이보경헤어샵 사가정점,1,1,1,3
3270,s1680877991,1680877991,꿈꾸는머리나라,1,1,1,3
3271,sk18568747,k18568747,정미용실,1,1,1,3
3272,s20891316,20891316,김지현헤어비스,1,1,1,3
3273,s33049706,33049706,다모아미용실,1,1,1,3
3274,s20856443,20856443,최혜선미용실,1,1,1,3
3275,s1054607914,1054607914,연헤어,1,1,1,3
3276,s20906320,20906320,윤희미용실,1,1,1,3
3277,s20879848,20879848,동미용실,1,1,1,3
3278,s703992461,703992461,태성미용실,1,1,1,3
3279,s20844919,20844919,정헤어샵,1,1,1,3
3280,s18550478,18550478,헤어디자인클럽,1,1,1,3
3281,s1390267207,1390267207,헤어아트,1,1,1,3
3282,s20887387,20887387,권문혜헤어아트,1,1,1,3
3283,s141110311,141110311,진화미용실,1,1,1,3
3284,s1610118429,1610118429,스파리움 현대백화점미아점,1,1,1,3
3285,s32786295,32786295,개성시대,1,1,1,3
3286,s13151767,13151767,아쿠아헤어,1,1,1,3
3287,s20934591,20934591,라크슈미헤어,1,1,1,3
3288,s1398100345,1398100345,바닐라헤어,1,1,1,3
3289,s1393823517,1393823517,주여니헤어,1,1,1,3
3290,s18901441,18901441,김명숙헤어숍,1,1,1,3
3291,s20866761,20866761,온유헤어,1,1,1,3
3292,s1627654728,1627654728,미랑헤어,1,1,1,3
3293,s20939273,20939273,미강헤어,1,1,1,3
3294,s20831936,20831936,해피헤어샵,1,1,1,3
3295,s1970693036,1970693036,머리사랑,1,1,1,3
3296,s1323149121,1323149121,단발머리,1,1,1,3
3297,s20870720,20870720,단발머리,1,1,1,3
3298,s1950308743,1950308743,은미용실,1,1,1,3
3299,s18573261,18573261,정지혜미용실,1,1,1,3
3300,s18852088,18852088,권혜경헤어타임,1,1,1,3
3301,s20722561,20722561,선화헤어아트,1,1,1,3
3302,s1366509253,1366509253,박현정헤어요술쟁이,1,1,1,3
3303,s1589340135,1589340135,피망미용실,1,1,1,3
3304,s20866794,20866794,보림헤어,1,1,1,3
3305,s37439497,37439497,더스타일나비,1,1,1,3
3306,s20874357,20874357,아띠미장,1,1,1,3
3307,s19763846,19763846,러블리헤어샵,1,1,1,3
3308,s18519708,18519708,로얄미용실,1,1,1,3
3309,s13157211,13157211,황헤어랜드,1,1,1,3
3310,s1430515014,1430515014,정희헤어샵,1,1,1,3
3311,s1716924334,1716924334,우성미용실,1,1,1,3
3312,s11475756,11475756,뉴스킨헤어인테크,1,1,1,3
3313,s20873490,20873490,에오스헤어,1,1,1,3
3314,s12040351,12040351,헤어끌레오,1,1,1,3
3315,s20924097,20924097,써니헤어,1,1,1,3
3316,s1087391998,1087391998,헤어라인,1,1,1,3
3317,s904317776,904317776,수헤어,1,1,1,3
3318,s20607980,20607980,미가헤어,1,1,1,3
3319,s13151769,13151769,빠마닷컴,1,1,1,3
3320,s19412445,19412445,쿨헤어라인,1,1,1,3
3321,s20859053,20859053,헤어플레임,1,1,1,3
3322,s18495544,18495544,헤어살롱카라,1,1,1,3
3323,s1976831112,1976831112,하나헤어샵,1,1,1,3
3324,s1446531219,1446531219,이숙희헤어,1,1,1,3
3325,s38419564,38419564,성북동헤어살롱,1,1,1,3
3326,s896220432,896220432,헤어살롱헤윰,1,1,1,3
3327,s1591713840,1591713840,헤어로드,1,1,1,3
3328,s1086112636,1086112636,이레미용실,1,1,1,3
3329,s526020136,526020136,승현머리방,1,1,1,3
3330,s1673728388,1673728388,미스터,1,1,1,3
3331,s36934113,36934113,조현미용실,1,1,1,3
3332,s1428560733,1428560733,올림픽상가 단헤어팀,1,1,1,3
3333,s1488926520,1488926520,라보떼헤어샵,1,1,1,3
3334,s1364590073,1364590073,S감성헤어성북점,1,1,1,3
3335,s1049390320,1049390320,다영헤어,1,1,1,3
3336,s1731140255,1731140255,토마토헤어,1,1,1,3
3337,s685959870,685959870,헤어바이린,1,1,1,3
3338,s1959687744,1959687744,박미진헤어,1,1,1,3
3339,s1912885752,1912885752,엠헤어,1,1,1,3
3340,s1622475451,1622475451,제이헤어,1,1,1,3
3341,s1444757856,1444757856,뮤헤어,1,1,1,3
3342,s18470745,18470745,헤어코코,1,1,1,3
3343,s21105893,21105893,아코리스헤어드레싱,1,1,1,3
3344,s1275082013,1275082013,지홍헤어샵,1,1,1,3
3345,s20830969,20830969,홍헤어,1,1,1,3
3346,s20623636,20623636,쎄씨헤어,1,1,1,3
3347,s173080099,173080099,헤어사랑,1,1,1,3
3348,s1947467943,1947467943,강은주hair,1,1,1,3
3349,s20865772,20865772,정순헤어샵,1,1,1,3
3350,s34352699,34352699,우리미용실,1,1,1,3
3351,s20421160,20421160,라온헤어스토리,1,1,1,3
3352,s1634113033,1634113033,세이크헤어,1,1,1,3
3353,s89097861,89097861,헤어매직,1,1,1,3
3354,s35643888,35643888,hair magic,1,1,1,3
3355,s18903367,18903367,보보미용실,1,1,1,3
3356,s1144112602,1144112602,양리헤어,1,1,1,3
3357,s1366843374,1366843374,지앤지헤어스튜디오,1,1,1,3
3358,s18559510,18559510,예림헤어,1,1,1,3
3359,s20895026,20895026,호산나미용실,1,1,1,3
3360,s18557870,18557870,김미용실,1,1,1,3
3361,s776408443,776408443,에스헤어샵,1,1,1,3
3362,s31397113,31397113,더헤어갤러리,1,1,1,3
3363,s20896412,20896412,정운미용실,1,1,1,3
3364,s20858935,20858935,권때아쟝3호점,1,1,1,3
3365,s19776090,19776090,김지윤헤어,1,1,1,3
3366,s1574072038,1574072038,샴푸헤어,1,1,1,3
3367,s35135954,35135954,쉬크헤어,1,1,1,3
3368,s18924394,18924394,더헤어,1,1,1,3
3369,s20852653,20852653,아씨미용실,1,1,1,3
3370,s1696043765,1696043765,예진아씨헤어,1,1,1,3
3371,s13376279,13376279,더스타일헤어 정릉점,1,1,1,3
3372,s673578166,673578166,쉬즈모헤어,1,1,1,3
3373,s20861900,20861900,리치헤어,1,1,1,3
3374,s20881346,20881346,명품헤어,1,1,1,3
3375,s976900125,976900125,선스헤어,1,1,1,3
3376,s20844933,20844933,헤어스케치,1,1,1,3
3377,s20893469,20893469,에이치샵,1,1,1,3
3378,s20851404,20851404,미조방헤어아트,1,1,1,3
3379,s1156213498,1156213498,왕비헤어,1,1,1,3
3380,s1756120788,1756120788,헤어엠프레스,1,1,1,3
3381,s20904890,20904890,미소1 장위동점,1,1,1,3
3382,s1062156247,1062156247,헤어야미용실,1,1,1,3
3383,s18476560,18476560,유림미용실,1,1,1,3
3384,s520207891,520207891,은진미용실,1,1,1,3
3385,s20329282,20329282,클랑헤어,1,1,1,3
3386,s1902081288,1902081288,마르떼헤어,1,1,1,3
3387,s18511875,18511875,헤어까미,1,1,1,3
3388,s18866207,18866207,윤선미용실,1,1,1,3
3389,s34352001,34352001,최선헤어샵,1,1,1,3
3390,s18479892,18479892,헤어드레서,1,1,1,3
3391,s20874427,20874427,무지개미용실,1,1,1,3
3392,s20843542,20843542,이경숙헤어아트,1,1,1,3
3393,s21602668,21602668,꺼멍머리헤어,1,1,1,3
3394,s1940289991,1940289991,김지은헤어클럽,1,1,1,3
3395,s18888828,18888828,헤어플레너,1,1,1,3
3396,s18853514,18853514,이선기미용실,1,1,1,3
3397,s1262294547,1262294547,살롱드 봄,1,1,1,3
3398,s18486269,18486269,에스더헤어살롱,1,1,1,3
3399,s18560509,18560509,파인헤어아트,1,1,1,3
3400,s572250144,572250144,현이네머리방,1,1,1,3
3401,s1230265422,1230265422,라인헤어,1,1,1,3
3402,s19743695,19743695,W헤어,1,1,1,3
3403,s1882513596,1882513596,윤지헤어,1,1,1,3
3404,s1014661355,1014661355,라움헤어,1,1,1,3
3405,s1964156917,1964156917,컷트마당,1,1,1,3
3406,s1051144905,1051144905,수헤어,1,1,1,3
3407,s20910308,20910308,이슈헤어,1,1,1,3
3408,s36005281,36005281,금메달미용실,1,1,1,3
3409,s1068687500,1068687500,장가가머리하는곳,1,1,1,3
3410,s37471199,37471199,하예성 미용실,1,1,1,3
3411,s37411834,37411834,언니네살롱,1,1,1,3
3412,s1923193687,1923193687,더끌림헤어,1,1,1,3
3413,s1485658985,1485658985,옻안타는천연연색 보문점,1,1,1,3
3414,s1094145586,1094145586,장스헤어클럽,1,1,1,3
3415,s36444608,36444608,디자인에이플러스헤어살롱,1,1,1,3
3416,s20393608,20393608,엘리자베스테일러,1,1,1,3
3417,s1139688572,1139688572,루다헤어,1,1,1,3
3418,s1304137314,1304137314,천연염색방,1,1,1,3
3419,s36160719,36160719,쉐르헤어살롱,1,1,1,3
3420,s1769195705,1769195705,아프리카헤어,1,1,1,3
3421,s1310486819,1310486819,헤어코코,1,1,1,3
3422,s1480043616,1480043616,골드헤어,1,1,1,3
3423,s1416339634,1416339634,송파시범이용원,1,1,1,3
3424,s37606766,37606766,권때아쟝,1,1,1,3
3425,s37109240,37109240,헤어마들,1,1,1,3
3426,s1625878389,1625878389,코코살롱,1,1,1,3
3427,s18553409,18553409,양지헤어센스,1,1,1,3
3428,s36655409,36655409,hhair,1,1,1,3
3429,s1034246012,1034246012,강민경헤어샵,1,1,1,3
3430,s1063645764,1063645764,헤어담,1,1,1,3
3431,s583780567,583780567,쥬노헤어샵,1,1,1,3
3432,s18273551,18273551,까까머리헤어샵,1,1,1,3
3433,s1027789278,1027789278,머리하는집,1,1,1,3
3434,s1074762335,1074762335,미쉘헤어,1,1,1,3
3435,s1447320217,1447320217,JY헤어,1,1,1,3
3436,s37756030,37756030,아토즈 헤어,1,1,1,3
3437,s1628432874,1628432874,두가이헤어샵,1,1,1,3
3438,s31487350,31487350,온새미로 by수빈,1,1,1,3
3439,s1827250834,1827250834,예쁜머리만들기,1,1,1,3
3440,s37746363,37746363,시연헤어살롱,1,1,1,3
3441,s1374791232,1374791232,제이제이헤어,1,1,1,3
3442,s80606202,80606202,이정뷰티,1,1,1,3
3443,s1626715680,1626715680,헤어화,1,1,1,3
3444,s20930848,20930848,룰루랄라헤어샵면목본점,1,1,1,3
3445,s37211526,37211526,김보영머리사랑,1,1,1,3
3446,s36513433,36513433,1976's HAIR SALON,1,1,1,3
3447,s1098125278,1098125278,헤어뜨레,1,1,1,3
3448,s37488873,37488873,올라헤어,1,1,1,3
3449,s34658744,34658744,태후사랑 잠실점,1,1,1,3
3450,s36684396,36684396,더루쓰헤어,1,1,1,3
3451,s1111592305,1111592305,토마토헤어,1,1,1,3
3452,s21392632,21392632,정용호헤어갤러리,1,1,1,3
3453,s1485259219,1485259219,애니헤어,1,1,1,3
3454,s37343081,37343081,세인헤어,1,1,1,3
3455,s1437277336,1437277336,지투헤어샵,1,1,1,3
3456,s1731182073,1731182073,더뷰티샵블루,1,1,1,3
3457,s1249190313,1249190313,쎄이염색샵,1,1,1,3
3458,s20632376,20632376,뷰티공감미용실,1,1,1,3
3459,s36211566,36211566,비제이헤어,1,1,1,3
3460,s1126252247,1126252247,태후사랑미용실,1,1,1,3
3461,s157705908,157705908,루이치헤어,1,1,1,3
3462,s34351814,34351814,이지헤어,1,1,1,3
3463,s20898769,20898769,헤어플러스,1,1,1,3
3464,s32772897,32772897,리오헤어,1,1,1,3
3465,s18233536,18233536,고경희헤어살롱,1,1,1,3
3466,s18573265,18573265,율리아나헤어포인트,1,1,1,3
3467,s735926619,735926619,사이리즘헤어 동덕여대점,1,1,1,3
3468,s1433228436,1433228436,지은헤어,1,1,1,3
3469,s37811686,37811686,칼라비 헤어,1,1,1,3
3470,s1565855386,1565855386,원식스헤어,1,1,1,3
3471,s1199274463,1199274463,기쁠희미용실,1,1,1,3
3472,s1053486313,1053486313,씨밀레헤어,1,1,1,3
3473,s1991173437,1991173437,루쓰헤어,1,1,1,3
3474,s1525621447,1525621447,간디헤어,1,1,1,3
3475,s146829247,146829247,아씨머리방,1,1,1,3
3476,s1024124075,1024124075,우리동네미용실,1,1,1,3
3477,s631283696,631283696,헤어매니저,1,1,1,3
3478,s1226206297,1226206297,최연정헤어,1,1,1,3
3479,s1890332372,1890332372,도로시헤어,1,1,1,3
3480,s34350640,34350640,러블리헤어,1,1,1,3
3481,s1691406055,1691406055,다인헤어살롱,1,1,1,3
3482,s1644618434,1644618434,S헤어,1,1,1,3
3483,s1825790664,1825790664,아우라헤어,1,1,1,3
3484,s1503401514,1503401514,김헤어,1,1,1,3
3485,s321845073,321845073,혜영헤어,1,1,1,3
3486,s20930813,20930813,머리사랑,1,1,1,3
3487,s527093446,527093446,Hair&Yu,1,1,1,3
3488,s20931764,20931764,HJ헤어,1,1,1,3
3489,s1769122995,1769122995,명품헤나미용실,1,1,1,3
3490,s18273555,18273555,댕기머리미용실,1,1,1,3
3491,s35890457,35890457,니나스살롱,1,1,1,3
3492,s18560514,18560514,서울미용실,1,1,1,3
3493,s35413047,35413047,Plan Hair,1,1,1,3
3494,s1985072845,1985072845,쎄븐헤어월드 2호점,1,1,1,3
3495,s35244344,35244344,마이크로헤어,1,1,1,3
3496,s1364402140,1364402140,더헤어살롱,1,1,1,3
3497,s20907970,20907970,베다니미용실,1,1,1,3
3498,s1622908258,1622908258,넘버원헤어,1,1,1,3
3499,s34401817,34401817,여우머리,1,1,1,3
3500,s34484777,34484777,잘헤어,1,1,1,3
3501,s37759893,37759893,최헤어디자인연구소,1,1,1,3
3502,s1547194785,1547194785,닥터고져스헤어,1,1,1,3
3503,s34351919,34351919,예손헤어샵,1,1,1,3
3504,s1892220011,1892220011,머리해요,1,1,1,3
3505,s1802568312,1802568312,독보적인 미용실,1,1,1,3
3506,s35317099,35317099,w헤어샵,1,1,1,3
3507,s18182326,18182326,임은앵헤어나라,1,1,1,3
3508,s18854719,18854719,메르쉬송파점,1,1,1,3
3509,s1420269380,1420269380,바비헤어,1,1,1,3
3510,s20900349,20900349,민정헤어아트,1,1,1,3
3511,s1631616886,1631616886,헤어맨,1,1,1,3
3512,s1955009080,1955009080,카라미용실,1,1,1,3
3513,s37918677,37918677,더순수헤어,1,1,1,3
3514,s37918680,37918680,별난머리헤어살롱,1,1,1,3
3515,s32517059,32517059,정헤어모드,1,1,1,3
3516,s34722001,34722001,더헤어,1,1,1,3
3517,s18899926,18899926,성신파마의집,1,1,1,3
3518,s1721873828,1721873828,성우미용실,1,1,1,3
3519,s1870280768,1870280768,천국1인헤어,1,1,1,3
3520,s1578002924,1578002924,샘미용실,1,1,1,3
3521,s37615961,37615961,디헤어바이제이,1,1,1,3
3522,s1392653412,1392653412,M&M붙임머리,1,1,1,3
3523,s1093546061,1093546061,촘촘뷰티,1,1,1,3
3524,s1253544449,1253544449,나이스가이 프리미엄 서초점,1,1,1,3
3525,s1031849924,1031849924,아미헤어,1,1,1,3
3526,s1854762720,1854762720,카카오헤어샵,1,1,1,3
3527,s1209185019,1209185019,THE예쁜날헤어,1,1,1,3
3528,s18323719,18323719,예지미용실,1,1,1,3
3529,s20638793,20638793,김정남미용실,1,1,1,3
3530,s1860658036,1860658036,헤어필,1,1,1,3
3531,s1329651699,1329651699,가은헤어,1,1,1,3
3532,s31185033,31185033,쉬스헤어,1,1,1,3
3533,s1768341472,1768341472,에덴헤어,1,1,1,3
3534,s1250189743,1250189743,Eden hair,1,1,1,3
3535,s20858162,20858162,유헤어샵,1,1,1,3
3536,s1128860935,1128860935,신신미용실,1,1,1,3
3537,s18770791,18770791,하수연미용실,1,1,1,3
3538,s752949647,752949647,지니뷰티&헤어,1,1,1,3
3539,s18323678,18323678,마당미용실,1,1,1,3
3540,s13150679,13150679,귀빈헤어클럽,1,1,1,3
3541,s442655948,442655948,헤어빈,1,1,1,3
3542,s87250945,87250945,박찬희미용실,1,1,1,3
3543,s1901023206,1901023206,브러쉬헤어,1,1,1,3
3544,s132740610,132740610,이훈ALL30000 상봉점,1,1,1,3
3545,s921416373,921416373,뱅헤어2호점,1,1,1,3
3546,s20045650,20045650,신재화미용실,1,1,1,3
3547,s38556172,38556172,뉴욕 5번가,1,1,1,3
3548,s934122848,934122848,헤이맨서초소망점,1,1,1,3
3549,s20878780,20878780,단심머리방,1,1,1,3
3550,s37383032,37383032,분헤어미용실,1,1,1,3
3551,s670660414,670660414,본헤어,1,1,1,3
3552,s18349013,18349013,G헤어샵,1,1,1,3
3553,s477936438,477936438,챠밍헤어,1,1,1,3
3554,s20624681,20624681,쉬즈미용실,1,1,1,3
3555,s18274563,18274563,진헤어,1,1,1,3
3556,s18267030,18267030,쎄븐헤어월드,1,1,1,3
3557,s1436355671,1436355671,김옥자헤어샵,1,1,1,3
3558,s1209177223,1209177223,김희수헤어샵,1,1,1,3
3559,s18873270,18873270,다온헤어,1,1,1,3
3560,s1889556005,1889556005,진헤어,1,1,1,3
3561,s18323730,18323730,코베라미용실,1,1,1,3
3562,s1274193502,1274193502,다인헤어,1,1,1,3
3563,s20901495,20901495,김선영헤어모드,1,1,1,3
3564,s20642992,20642992,오컷헤어살롱,1,1,1,3
3565,s1649864683,1649864683,이정미용실,1,1,1,3
3566,s1672909524,1672909524,디부부,1,1,1,3
3567,s18280418,18280418,미모1,1,1,1,3
3568,s20901497,20901497,미진헤어콜렉션,1,1,1,3
3569,s20637294,20637294,블루피쉬헤어,1,1,1,3
3570,s1122267852,1122267852,가위가머리를만날때,1,1,1,3
3571,s1894948599,1894948599,홍머리방,1,1,1,3
3572,s20634178,20634178,이연희헤어샵,1,1,1,3
3573,s1926184102,1926184102,이시스헤어,1,1,1,3
3574,s1859117759,1859117759,애두미용실,1,1,1,3
3575,s20643412,20643412,세븐헤어월드우면점,1,1,1,3
3576,s20625225,20625225,허신애미용실,1,1,1,3
3577,s36372757,36372757,샤인보이,1,1,1,3
3578,s1256127874,1256127874,이상희헤어라인,1,1,1,3
3579,s19747431,19747431,해리&샐리,1,1,1,3
3580,s1167128495,1167128495,머리하는날,1,1,1,3
3581,s465793673,465793673,애니마미용실,1,1,1,3
3582,s35438860,35438860,블루클럽 방배점,1,1,1,3
3583,s80294518,80294518,구명선헤어,1,1,1,3
3584,s37169123,37169123,정경운헤어Rray,1,1,1,3
3585,s38219890,38219890,다잘헤어,1,1,1,3
3586,s1870990739,1870990739,현헤어,1,1,1,3
3587,s18290362,18290362,나래네미용실,1,1,1,3
3588,s18223840,18223840,엘르미장,1,1,1,3
3589,s1396834948,1396834948,더컷헤어,1,1,1,3
3590,s1463225386,1463225386,바움,1,1,1,3
3591,s1634018900,1634018900,수미용실,1,1,1,3
3592,s20641319,20641319,헤어마당,1,1,1,3
3593,s13151666,13151666,혜원미용실,1,1,1,3
3594,s18292018,18292018,정하영미용실,1,1,1,3
3595,s1893501085,1893501085,윤헤어,1,1,1,3
3596,s1977305778,1977305778,여우만들기,1,1,1,3
3597,s18753471,18753471,김민지헤어샵,1,1,1,3
3598,s583803448,583803448,HAIRTOP,1,1,1,3
3599,s1223481129,1223481129,조희헤어샵,1,1,1,3
3600,s1733947098,1733947098,다인헤어,1,1,1,3
3601,s1930421365,1930421365,이레헤어,1,1,1,3
3602,s1695677844,1695677844,Y HAIR,1,1,1,3
3603,s1608548242,1608548242,결미용실,1,1,1,3
3604,s1650455773,1650455773,황s헤어,1,1,1,3
3605,s1405807096,1405807096,몽블헤어,1,1,1,3
3606,s1348565103,1348565103,문헤어,1,1,1,3
3607,s1031807087,1031807087,카라헤어,1,1,1,3
3608,s18744873,18744873,제이제이헤어샵,1,1,1,3
3609,s1051820108,1051820108,베이 바이 홍,1,1,1,3
3610,s1509993903,1509993903,이훈플랜30000,1,1,1,3
3611,s383647761,383647761,헤어져,1,1,1,3
3612,s1809504457,1809504457,헤어필,1,1,1,3
3613,s1136120746,1136120746,헤어스토리,1,1,1,3
3614,s655727594,655727594,헤어바이센슈얼,1,1,1,3
3615,s20920814,20920814,하나헤어,1,1,1,3
3616,s1772319921,1772319921,로위,1,1,1,3
3617,s21575100,21575100,세마헤어 신촌점,1,1,1,3
3618,s37592316,37592316,인투헤어 2호점,1,1,1,3
3619,s13153936,13153936,더피엘헤어,1,1,1,3
3620,s35069789,35069789,보이지않는차이헤어,1,1,1,3
3621,s13114370,13114370,린다헤어,1,1,1,3
3622,s18329882,18329882,은아헤어,1,1,1,3
3623,s18329877,18329877,권태복헤어채널,1,1,1,3
3624,s20902211,20902211,미주헤어,1,1,1,3
3625,s20906316,20906316,조희미용실,1,1,1,3
3626,sk1204030384,k1204030384,봄애,1,1,1,3
3627,s1178856721,1178856721,티치훈,1,1,1,3
3628,s1576836818,1576836818,봄봄머리방,1,1,1,3
3629,s1555676135,1555676135,우리미용실,1,1,1,3
3630,s38642685,38642685,헤어스토리,1,1,1,3
3631,s1244710030,1244710030,블루클럽 가재울지구점,1,1,1,3
3632,s1887158077,1887158077,고은미용실,1,1,1,3
3633,s1910018238,1910018238,제이헤어샵,1,1,1,3
3634,s1738217867,1738217867,브러쉬헤어,1,1,1,3
3635,s1549380767,1549380767,이룸헤어,1,1,1,3
3636,s1779560425,1779560425,살롱226,1,1,1,3
3637,s1209720897,1209720897,미 플러스 헤어샵,1,1,1,3
3638,s1965205523,1965205523,헤어봄,1,1,1,3
3639,s1621054099,1621054099,착한헤어,1,1,1,3
3640,s20881320,20881320,한빛미용실,1,1,1,3
3641,s1597120097,1597120097,큐사랑염색방,1,1,1,3
3642,s1785735332,1785735332,살롱드헤어148,1,1,1,3
3643,s1666560953,1666560953,옻안타는천연염색 홍제점,1,1,1,3
3644,s313303685,313303685,리즈헤어,1,1,1,3
3645,s1780373190,1780373190,나리미용실,1,1,1,3
3646,s1482310008,1482310008,살롱 드 별,1,1,1,3
3647,s34461224,34461224,아리미용실,1,1,1,3
3648,s729875513,729875513,이화헤어,1,1,1,3
3649,s1782641968,1782641968,박연국헤어쉼,1,1,1,3
3650,s1478564407,1478564407,다비다헤어살롱,1,1,1,3
3651,s1129182373,1129182373,경로미용실,1,1,1,3
3652,s1385077881,1385077881,더스타일링헤어,1,1,1,3
3653,s1540815271,1540815271,까벨로헤어,1,1,1,3
3654,s1766237255,1766237255,엣지헤어,1,1,1,3
3655,s1188330447,1188330447,원미용실,1,1,1,3
3656,s20904085,20904085,프라헤어,1,1,1,3
3657,s1886647890,1886647890,수헤어컬러샾,1,1,1,3
3658,s20850298,20850298,샤론미용실,1,1,1,3
3659,s287525352,287525352,박준뷰티랩 2001아울렛 천호점,1,1,1,3
3660,s1641995497,1641995497,리시오헤어,1,1,1,3
3661,s36305470,36305470,H STYLE헤어살롱 신내점,1,1,1,3
3662,s1645660797,1645660797,썬헤어샵,1,1,1,3
3663,s20827137,20827137,헤어썬,1,1,1,3
3664,s36466108,36466108,태후사랑 면목5동점,1,1,1,3
3665,s1474872737,1474872737,헤어사랑염색방,1,1,1,3
3666,s1628368082,1628368082,올리브헤어,1,1,1,3
3667,s1946167688,1946167688,리코헤어,1,1,1,3
3668,s1353156230,1353156230,헤어갤러리,1,1,1,3
3669,s19350289,19350289,조이헤어아트,1,1,1,3
3670,s21810760,21810760,일공이헤어,1,1,1,3
3671,s1125871658,1125871658,더엠브이지클럽,1,1,1,3
3672,s595463239,595463239,로즈펌헤어,1,1,1,3
3673,s1023985863,1023985863,아미가미용실,1,1,1,3
3674,s1746939152,1746939152,베니스헤어,1,1,1,3
3675,s1246459113,1246459113,한독머리방,1,1,1,3
3676,s1432299303,1432299303,MH맨헤어 논현점,1,1,1,3
3677,s21023836,21023836,이수오,1,1,1,3
3678,s37397762,37397762,케네스송헤어,1,1,1,3
3679,s590758995,590758995,아르스헤어,1,1,1,3
3680,s906843022,906843022,헤어스케치,1,1,1,3
3681,s37537969,37537969,위너헤어,1,1,1,3
3682,s20934482,20934482,김지영헤어리더,1,1,1,3
3683,s1327416507,1327416507,에이치헤어,1,1,1,3
3684,s13150231,13150231,김주현헤어공간,1,1,1,3
3685,s992263783,992263783,고운손길,1,1,1,3
3686,s1316476217,1316476217,머리염색방,1,1,1,3
3687,s37008506,37008506,리안헤어 서초내곡점,1,1,1,3
3688,s722650192,722650192,샴푸로 염색하세요,1,1,1,3
3689,s38464795,38464795,정연헤어,1,1,1,3
3690,s36823842,36823842,DK HAIR,1,1,1,3
3691,s1313477139,1313477139,폴라리스헤어샵,1,1,1,3
3692,s13150535,13150535,예시카,1,1,1,3
3693,s604129416,604129416,미학미용실,1,1,1,3
3694,s20622264,20622264,각시머리방,1,1,1,3
3695,s726511152,726511152,타임헤어서초점,1,1,1,3
3696,s999827978,999827978,헤어카페,1,1,1,3
3697,s18358188,18358188,성민미용실,1,1,1,3
3698,s37879910,37879910,샤르망헤어,1,1,1,3
3699,s20896635,20896635,현주머리방,1,1,1,3
3700,s18882751,18882751,유로헤어,1,1,1,3
3701,s36005295,36005295,보원헤어,1,1,1,3
3702,s290854837,290854837,수연헤어,1,1,1,3
3703,s20873683,20873683,세민미용실,1,1,1,3
3704,s20892543,20892543,이승희헤어클럽,1,1,1,3
3705,s36690422,36690422,에이프릴헤어,1,1,1,3
3706,s1770728163,1770728163,헤어마담봉,1,1,1,3
3707,s65072877,65072877,찬오헤어,1,1,1,3
3708,s1739087366,1739087366,플라워헤어,1,1,1,3
3709,s37588457,37588457,저스트헤어,1,1,1,3
3710,s18369606,18369606,김경희헤어스케치,1,1,1,3
3711,s38767244,38767244,가인미용실,1,1,1,3
3712,s20874674,20874674,강남헤어샵,1,1,1,3
3713,s1035661482,1035661482,오형석 미용실,1,1,1,3
3714,s1427912393,1427912393,예스헤어,1,1,1,3
3715,s1875943015,1875943015,아우라헤어,1,1,1,3
3716,s1228717087,1228717087,아우라더헤어,1,1,1,3
3717,s707021706,707021706,기분좋은날Hair반포점,1,1,1,3
3718,s18368505,18368505,아비가일헤어샵,1,1,1,3
3719,s1693186938,1693186938,홍쓰스타일,1,1,1,3
3720,s728226995,728226995,살롱 드 하우스,1,1,1,3
3721,s35150490,35150490,Hair by J,1,1,1,3
3722,s777499890,777499890,제이앤퓨어,1,1,1,3
3723,s38693088,38693088,헤어망고 방배점,1,1,1,3
3724,s1111733977,1111733977,헤어ss,1,1,1,3
3725,s20851595,20851595,가위손헤어,1,1,1,3
3726,s1348078761,1348078761,하루헤어,1,1,1,3
3727,s20892829,20892829,보리헤어살롱,1,1,1,3
3728,s294664136,294664136,뱅미용실,1,1,1,3
3729,s37917666,37917666,헬로우컷 양재우면점,1,1,1,3
3730,s1431813863,1431813863,머리하는날,1,1,1,3
3731,s38453959,38453959,블루클럽 양재역점,1,1,1,3
3732,s964842436,964842436,주헤어살롱,1,1,1,3
3733,s1633094433,1633094433,골드헤어,1,1,1,3
3734,s1602157189,1602157189,공간헤어스튜디오,1,1,1,3
3735,s20861803,20861803,대명미용실,1,1,1,3
3736,s20850386,20850386,이젤헤어터치,1,1,1,3
3737,s38332014,38332014,마론헤어,1,1,1,3
3738,s20919163,20919163,미헤어갤러리,1,1,1,3
3739,s32256603,32256603,쉬즈헤어,1,1,1,3
3740,s11730062,11730062,블루클럽 영동사거리점,1,1,1,3
3741,s628130195,628130195,MARON,1,1,1,3
3742,s606634962,606634962,SKR미모헤어살롱,1,1,1,3
3743,s37691534,37691534,JnJ 헤어샵,1,1,1,3
3744,s1077033618,1077033618,제이샵헤어살롱,1,1,1,3
3745,s291638041,291638041,지베르니,1,1,1,3
3746,s1712470722,1712470722,피오니 헤어,1,1,1,3
3747,s83103894,83103894,w헤어,1,1,1,3
3748,s13305137,13305137,타임헤어살롱,1,1,1,3
3749,s20548504,20548504,코코미용실,1,1,1,3
3750,s31730172,31730172,헤어파크,1,1,1,3
3751,s20637349,20637349,꽃보다남자본점,1,1,1,3
3752,s961030593,961030593,레이디헤어,1,1,1,3
3753,s38462485,38462485,슈가헤어 사가정점,1,1,1,3
3754,s1869147889,1869147889,HAIR  1994,1,1,1,3
3755,s37704701,37704701,티지헤어,1,1,1,3
3756,s20838866,20838866,김유정헤어,1,1,1,3
3757,s1371198444,1371198444,뉴헤어클럽,1,1,1,3
3758,s38486205,38486205,어반헤어,1,1,1,3
3759,s18248383,18248383,선화미용실,1,1,1,3
3760,s20383487,20383487,행복드림헤어샵,1,1,1,3
3761,s1276109241,1276109241,서연헤어카페,1,1,1,3
3762,s1394072465,1394072465,김성주헤어샵,1,1,1,3
3763,s903419026,903419026,나윤헤어,1,1,1,3
3764,s20834773,20834773,루디아헤어,1,1,1,3
3765,s20498948,20498948,메종드도로시,1,1,1,3
3766,s1503558084,1503558084,헤어닥터미용실,1,1,1,3
3767,s329444032,329444032,쏘니아윤미용실,1,1,1,3
3768,s18291958,18291958,제나헤어,1,1,1,3
3769,s20643710,20643710,비주얼헤어,1,1,1,3
3770,s32258218,32258218,몰리헤어,1,1,1,3
3771,s1781504286,1781504286,주리헤어샵,1,1,1,3
3772,s475374894,475374894,김정현헤어 중화역점,1,1,1,3
3773,s12823537,12823537,헤어에비뉴,1,1,1,3
3774,s13129635,13129635,가인헤어,1,1,1,3
3775,s1876104916,1876104916,자자헤어,1,1,1,3
3776,s18189424,18189424,선희미용실,1,1,1,3
3777,s20865942,20865942,최리정헤어,1,1,1,3
3778,s18373684,18373684,코베라헤어살롱,1,1,1,3
3779,s37038891,37038891,이담헤어살롱,1,1,1,3
3780,s31935771,31935771,까미헤어,1,1,1,3
3781,s20874655,20874655,헤어공감,1,1,1,3
3782,s1226564972,1226564972,금빛헤어,1,1,1,3
3783,s1398613371,1398613371,헤어캐슬,1,1,1,3
3784,s1658894857,1658894857,오투헤어,1,1,1,3
3785,s34584958,34584958,코코헤어,1,1,1,3
3786,s841706133,841706133,헤어캐슬,1,1,1,3
3787,s1113003522,1113003522,머리사랑 면목점,1,1,1,3
3788,s33535204,33535204,살롱드리베르떼,1,1,1,3
3789,s33625098,33625098,STUDIO34헤어살롱,1,1,1,3
3790,s32423569,32423569,블루클럽 우면점,1,1,1,3
3791,s37848255,37848255,살롱드케이,1,1,1,3
3792,s32581615,32581615,살롱드벨,1,1,1,3
3793,s1614768938,1614768938,우노바이란,1,1,1,3
3794,s37349507,37349507,태후사랑 방배역점,1,1,1,3
3795,s13150602,13150602,Salon J  HAIR,1,1,1,3
3796,s278716325,278716325,MAY21,1,1,1,3
3797,s466195382,466195382,멋진남자,1,1,1,3
3798,s20846692,20846692,가꿈헤어,1,1,1,3
3799,s35544181,35544181,카나헤어 서초점,1,1,1,3
3800,sk1621224449,k1621224449,미용1,1,1,1,3
3801,s34356566,34356566,송지윤헤어프로포즈,1,1,1,3
3802,s80331232,80331232,젠틀맨커트클럽,1,1,1,3
3803,s35554344,35554344,헤어캐슬,1,1,1,3
3804,s18765536,18765536,탤렌트,1,1,1,3
3805,s73514073,73514073,코지헤어,1,1,1,3
3806,s1679935235,1679935235,포인트헤어,1,1,1,3
3807,s1103612651,1103612651,오투헤어,1,1,1,3
3808,s1436507762,1436507762,글로우헤어,1,1,1,3
3809,s21445424,21445424,끌림 서래마을점,1,1,1,3
3810,s20931997,20931997,팡파르헤어클럽,1,1,1,3
3811,s31088246,31088246,데비스,1,1,1,3
3812,s31729349,31729349,헤어마지아,1,1,1,3
3813,s36513124,36513124,헤어홀릭,1,1,1,3
3814,s1277173081,1277173081,보체헤어,1,1,1,3
3815,s1761834291,1761834291,슈가헤어,1,1,1,3
3816,s36188364,36188364,씬헤어,1,1,1,3
3817,s183048559,183048559,예다움헤어,1,1,1,3
3818,s1698714045,1698714045,헤어블루,1,1,1,3
3819,s21393018,21393018,윤스헤어,1,1,1,3
3820,s1518229508,1518229508,비비드수헤어,1,1,1,3
3821,s1855997797,1855997797,뮤즈헤어,1,1,1,3
3822,s19454096,19454096,하루헤어,1,1,1,3
3823,s1891526574,1891526574,희미용실,1,1,1,3
3824,s1498905473,1498905473,사랑채싸롱미용실,1,1,1,3
3825,s1959938232,1959938232,씨저헤어,1,1,1,3
3826,s20928407,20928407,왁스,1,1,1,3
3827,s20916936,20916936,HIZMO,1,1,1,3
3828,s1868557726,1868557726,현화미용실,1,1,1,3
3829,s20820697,20820697,모노헤어,1,1,1,3
3830,s20932256,20932256,진달래헤어샵,1,1,1,3
3831,s20859577,20859577,롯데헤어샵,1,1,1,3
3832,s20919224,20919224,헤어코코,1,1,1,3
3833,s37379074,37379074,제니헤어 명지대점,1,1,1,3
3834,s20859531,20859531,레아헤어,1,1,1,3
3835,s37542659,37542659,조이헤어,1,1,1,3
3836,s1411496140,1411496140,다연헤어,1,1,1,3
3837,s37879567,37879567,라브리지,1,1,1,3
3838,s34069274,34069274,NB늘봄헤어 명지대점,1,1,1,3
3839,s1667824237,1667824237,수지미용실,1,1,1,3
3840,s1606675980,1606675980,마샬미용실,1,1,1,3
3841,s1698200105,1698200105,수정헤어,1,1,1,3
3842,s1525007775,1525007775,S2 Hair design,1,1,1,3
3843,s36741143,36741143,정헤어,1,1,1,3
3844,s31395605,31395605,장희헤어샵,1,1,1,3
3845,s1842538306,1842538306,예드니헤어샵,1,1,1,3
3846,s1787422768,1787422768,김수복헤어아트,1,1,1,3
3847,s20901696,20901696,준헤어샵,1,1,1,3
3848,s37003172,37003172,머리에반하다,1,1,1,3
3849,s1902821419,1902821419,까끼까끼,1,1,1,3
3850,s1326697119,1326697119,맨컷,1,1,1,3
3851,s1704656149,1704656149,씨엠헤어,1,1,1,3
3852,s1821581406,1821581406,헤어블로,1,1,1,3
3853,s37929242,37929242,김민설헤어플랜,1,1,1,3
3854,s1831935708,1831935708,이상희 헤어라인,1,1,1,3
3855,s1930566083,1930566083,헤어스케치,1,1,1,3
3856,s36005270,36005270,한양헤어클리닉,1,1,1,3
3857,s38514066,38514066,동네미용실,1,1,1,3
3858,s20836435,20836435,커커헤어아트,1,1,1,3
3859,s1038925788,1038925788,굿스토리헤어,1,1,1,3
3860,s20936075,20936075,수지헤어샵,1,1,1,3
3861,s20840159,20840159,은혜머리방,1,1,1,3
3862,s1217717265,1217717265,예향헤어커커,1,1,1,3
3863,s1874993877,1874993877,남성헤어컷  블랙앤화이트,1,1,1,3
3864,s18333886,18333886,준미용실,1,1,1,3
3865,s18742499,18742499,희미용실,1,1,1,3
3866,s18278309,18278309,모두헤어라인,1,1,1,3
3867,s18349940,18349940,초이미용실,1,1,1,3
3868,s1716211494,1716211494,헤어꾼,1,1,1,3
3869,s13320299,13320299,헤어셰프 미용실,1,1,1,3
3870,s18753994,18753994,댕기푸리,1,1,1,3
3871,s36317225,36317225,SALON DE 로이,1,1,1,3
3872,s18747971,18747971,이진숙미용실,1,1,1,3
3873,sk1921641224,k1921641224,포미헤어,1,1,1,3
3874,s1855668222,1855668222,연우헤어,1,1,1,3
3875,s1070730699,1070730699,그집미용실,1,1,1,3
3876,s20840215,20840215,로데오헤어샵,1,1,1,3
3877,s20924493,20924493,김지향헤어클럽,1,1,1,3
3878,s1837142348,1837142348,천연염색전문헤어샵,1,1,1,3
3879,s31392503,31392503,초이스헤어아트,1,1,1,3
3880,s1097902912,1097902912,코코헤어,1,1,1,3
3881,s18756252,18756252,이영주헤어비스,1,1,1,3
3882,s1856713233,1856713233,최윤선미용실,1,1,1,3
3883,s20855754,20855754,강윤영헤어갤러리,1,1,1,3
3884,s20874877,20874877,국제미용실,1,1,1,3
3885,s1126509265,1126509265,벽산헤어,1,1,1,3
3886,s1279531123,1279531123,조이헤어샵,1,1,1,3
3887,s1083686801,1083686801,오렌지헤어,1,1,1,3
3888,s18760479,18760479,경진헤어라인,1,1,1,3
3889,s18289182,18289182,이록머리여행,1,1,1,3
3890,s1672863798,1672863798,칼라터치미용실,1,1,1,3
3891,s18760381,18760381,숙헤어라인,1,1,1,3
3892,s18757614,18757614,호산나미용실,1,1,1,3
3893,s18754672,18754672,톰지헤어,1,1,1,3
3894,s37333024,37333024,아우라헤어,1,1,1,3
3895,s1417008070,1417008070,샤넬미용실,1,1,1,3
3896,s20836342,20836342,해림헤어샵,1,1,1,3
3897,s37117246,37117246,머리사랑붙임머리,1,1,1,3
3898,s20913129,20913129,상아미용실,1,1,1,3
3899,s20840289,20840289,사랑새미용실,1,1,1,3
3900,s1356660259,1356660259,민미용실,1,1,1,3
3901,s18284701,18284701,머리여행,1,1,1,3
3902,s30836451,30836451,선헤어샵,1,1,1,3
3903,s18753827,18753827,정헤어타운,1,1,1,3
3904,s18753489,18753489,정미용실,1,1,1,3
3905,s18257429,18257429,유진미용실,1,1,1,3
3906,s1208105155,1208105155,선영미용실,1,1,1,3
3907,s1408431504,1408431504,뽀꾸레미용실,1,1,1,3
3908,s20932103,20932103,정미용실,1,1,1,3
3909,s18738384,18738384,댕기머리,1,1,1,3
3910,s11492177,11492177,머리모양만들기,1,1,1,3
3911,s20901797,20901797,영헤어,1,1,1,3
3912,s18757780,18757780,햇님헤어갤러리,1,1,1,3
3913,s37838332,37838332,YUN HAIR,1,1,1,3
3914,s30833613,30833613,윤 헤어,1,1,1,3
3915,s11729973,11729973,블루클럽 충정로점,1,1,1,3
3916,s18740484,18740484,하늘헤어샵,1,1,1,3
3917,s18287204,18287204,다드므리미용실,1,1,1,3
3918,s1891104851,1891104851,은혜미용실,1,1,1,3
3919,s20925215,20925215,전혜정머리나라,1,1,1,3
3920,s31395959,31395959,연희헤어아트,1,1,1,3
3921,s1015372434,1015372434,헤어아트,1,1,1,3
3922,s1572123206,1572123206,김정환헤어살롱,1,1,1,3
3923,s1673511899,1673511899,청춘헤어,1,1,1,3
3924,s32618657,32618657,은서헤어샵,1,1,1,3
3925,s20859642,20859642,최헤어라인,1,1,1,3
3926,s18762809,18762809,조희헤어샵,1,1,1,3
3927,s19408439,19408439,한빛미용실,1,1,1,3
3928,s20890996,20890996,주연미용실,1,1,1,3
3929,s20848028,20848028,윤헤어모드,1,1,1,3
3930,s1556637303,1556637303,자애헤어라인,1,1,1,3
3931,s18228690,18228690,헤어시티,1,1,1,3
3932,s18762057,18762057,은총헤어,1,1,1,3
3933,s13152611,13152611,정영희헤어,1,1,1,3
3934,s38555521,38555521,임혜란헤어스튜디오,1,1,1,3
3935,s18759342,18759342,칼라미용실,1,1,1,3
3936,s1612908535,1612908535,진선헤어라인,1,1,1,3
3937,s20936081,20936081,김수정헤어클럽,1,1,1,3
3938,s31393239,31393239,하니헤어클럽,1,1,1,3
3939,s1401626381,1401626381,하니미용실,1,1,1,3
3940,s18736068,18736068,정철헤어센스,1,1,1,3
3941,s1854879204,1854879204,빛나미용실,1,1,1,3
3942,s1039130036,1039130036,김경란헤어,1,1,1,3
3943,s18228651,18228651,오미연미용실,1,1,1,3
3944,s18759799,18759799,윤정헤어라인,1,1,1,3
3945,s20913180,20913180,머리하는날,1,1,1,3
3946,s18278321,18278321,명지대헤어플러스,1,1,1,3
3947,s1566456732,1566456732,마블헤어팡팡,1,1,1,3
3948,s1837847525,1837847525,한마음헤어센스,1,1,1,3
3949,s1691637849,1691637849,헤어폼,1,1,1,3
3950,s31393214,31393214,JM미용실,1,1,1,3
3951,s18755711,18755711,헤어프로포즈,1,1,1,3
3952,s1138970710,1138970710,댕기머리,1,1,1,3
3953,s18208193,18208193,H헤어라인,1,1,1,3
3954,s1555547114,1555547114,미소헤어,1,1,1,3
3955,s1678030096,1678030096,미스터컷트,1,1,1,3
3956,s1461965945,1461965945,이지헤어,1,1,1,3
3957,s1564383995,1564383995,미헤어펌,1,1,1,3
3958,s1086928746,1086928746,주헤어컨트리,1,1,1,3
3959,s1270768476,1270768476,최주희헤어뱅크,1,1,1,3
3960,s18771966,18771966,진미용실,1,1,1,3
3961,sk15000419,k15000419,홍제헤어스케치,1,1,1,3
3962,s35263853,35263853,바바헤어,1,1,1,3
3963,s1782399354,1782399354,이훈헤어칼라 홍제점,1,1,1,3
3964,s1509042256,1509042256,안초이헤어,1,1,1,3
3965,s1515947809,1515947809,헤어스케치,1,1,1,3
3966,s18771878,18771878,헤어커플,1,1,1,3
3967,s1701741837,1701741837,쎄아떼 헤어,1,1,1,3
3968,s18740326,18740326,헤어짱,1,1,1,3
3969,s1010655745,1010655745,헤어플러스,1,1,1,3
3970,s1685101473,1685101473,서정헤어,1,1,1,3
3971,s1031210705,1031210705,대박이네 홍제미용실,1,1,1,3
3972,s298522015,298522015,이은지헤어컬렉션,1,1,1,3
3973,s1415278853,1415278853,아이리스헤어테코,1,1,1,3
3974,s15000421,15000421,몽구리헤어뷰티크,1,1,1,3
3975,s38555690,38555690,수헤어살롱,1,1,1,3
3976,s1039997287,1039997287,헤어앨리,1,1,1,3
3977,s18228617,18228617,미즈고미용실,1,1,1,3
3978,s1270680813,1270680813,큐사랑헤어염색방,1,1,1,3
3979,s1379086713,1379086713,진오헤어샵,1,1,1,3
3980,s35823777,35823777,그레이스K 미용실,1,1,1,3
3981,s1880862784,1880862784,태후사랑 홍제1동점,1,1,1,3
3982,s31397876,31397876,태후사랑 홍은점,1,1,1,3
3983,s1159857097,1159857097,태후사랑 연희점,1,1,1,3
3984,s11715943,11715943,더수컷,1,1,1,3
3985,s31391990,31391990,태후사랑천연점,1,1,1,3
3986,s20832594,20832594,H&J헤어,1,1,1,3
3987,s36943550,36943550,임미정미용실,1,1,1,3
3988,s1078970947,1078970947,유&미프로헤어,1,1,1,3
3989,s1487596372,1487596372,100세미용실,1,1,1,3
3990,s1353470699,1353470699,그레이스헤어,1,1,1,3
3991,s20934555,20934555,쁄라미용실,1,1,1,3
3992,s34744844,34744844,미소헤어,1,1,1,3
3993,s34589952,34589952,커트클럽,1,1,1,3
3994,s1467641582,1467641582,샤론미용실,1,1,1,3
3995,s1934424063,1934424063,마니에르헤어,1,1,1,3
3996,s1986955632,1986955632,오뜨헤어,1,1,1,3
3997,s32508788,32508788,제이헤어,1,1,1,3
3998,s1765557120,1765557120,러블리헤어,1,1,1,3
3999,s1844936244,1844936244,짤깍짤깍미용실,1,1,1,3
4000,s1482535775,1482535775,차쌤헤어,1,1,1,3
4001,s37747376,37747376,헤어카페 미용실,1,1,1,3
4002,s1739225877,1739225877,에덴미용실,1,1,1,3
4003,s33493249,33493249,루헤어샵,1,1,1,3
4004,s1086868069,1086868069,헤어살롱나무,1,1,1,3
4005,s34016349,34016349,손연서아르떼헤어,1,1,1,3
4006,s1185428395,1185428395,해피헤어,1,1,1,3
4007,s36208597,36208597,최가을헤어드레서 가재울뉴타운점,1,1,1,3
4008,s1519847109,1519847109,가위와머리꾼,1,1,1,3
4009,s1509057767,1509057767,러블리헤어샵,1,1,1,3
4010,s34345766,34345766,라온헤어,1,1,1,3
4011,s20861925,20861925,수빈헤어라인,1,1,1,3
4012,s1083658387,1083658387,기분좋은날헤어면목점,1,1,1,3
4013,s1472285913,1472285913,콩헤어,1,1,1,3
4014,s1018685638,1018685638,엠제이헤어,1,1,1,3
4015,s1568748068,1568748068,머리작업실옥희,1,1,1,3
4016,s1263555386,1263555386,제시인뉴욕 헤어샵,1,1,1,3
4017,s18257419,18257419,빗과머리결,1,1,1,3
4018,s1421826288,1421826288,라푼젤뷰티헤어샵,1,1,1,3
4019,s1349233010,1349233010,괜찮은미용실,1,1,1,3
4020,s38425877,38425877,2N HAIR,1,1,1,3
4021,s1593124757,1593124757,블링블링,1,1,1,3
4022,s1471333045,1471333045,미씨아씨헤어,1,1,1,3
4023,s1707534728,1707534728,윤성아헤어,1,1,1,3
4024,s20831035,20831035,헤어머리꾼,1,1,1,3
4025,s51425868,51425868,사랑채싸롱,1,1,1,3
4026,s1123071586,1123071586,포도쉬즈미 면목역점,1,1,1,3
4027,s1428347220,1428347220,성은미용실,1,1,1,3
4028,s1965880465,1965880465,장민우헤어,1,1,1,3
4029,s20922996,20922996,영헤어,1,1,1,3
4030,s1989510494,1989510494,스타일헤어,1,1,1,3
4031,s38301092,38301092,제이폭스헤어클럽 명지대점,1,1,1,3
4032,s1440602968,1440602968,가람헤어샾,1,1,1,3
4033,s37890058,37890058,벨라헤어,1,1,1,3
4034,s1294363401,1294363401,핑크헤어라인,1,1,1,3
4035,s1665801698,1665801698,다미헤어,1,1,1,3
4036,s37800919,37800919,헤어피크,1,1,1,3
4037,s20838753,20838753,궁전헤어클럽,1,1,1,3
4038,s1941589556,1941589556,진헤어샵,1,1,1,3
4039,s1170162344,1170162344,진헤어,1,1,1,3
4040,s1079741978,1079741978,민헤어,1,1,1,3
4041,s37766446,37766446,오모쿠헤어샵 가재울점,1,1,1,3
4042,s18760099,18760099,미장헤어살롱,1,1,1,3
4043,s1427502662,1427502662,민트헤어,1,1,1,3
4044,s1323198870,1323198870,벨라헤어,1,1,1,3
4045,s33627703,33627703,상상헤어,1,1,1,3
4046,s38705234,38705234,토리헤어 북가좌점,1,1,1,3
4047,s1931865637,1931865637,카리테스헤어,1,1,1,3
4048,s1258640655,1258640655,헤어살롱느낌,1,1,1,3
4049,s1184426593,1184426593,미앤미헤어,1,1,1,3
4050,s31099296,31099296,샤르망,1,1,1,3
4051,s18763606,18763606,미넷,1,1,1,3
4052,s1655753715,1655753715,헤어센스,1,1,1,3
4053,s37792532,37792532,오모쿠헤어샵 명지대점,1,1,1,3
4054,s31036844,31036844,주노미용실,1,1,1,3
4055,s18742495,18742495,제이미용실,1,1,1,3
4056,s37153785,37153785,탐탐헤어상봉점,1,1,1,3
4057,s20915681,20915681,홍헤어,1,1,1,3
4058,s1489207375,1489207375,라일락향기처럼,1,1,1,3
4059,s13150871,13150871,한미라헤어공감,1,1,1,3
4060,s20924574,20924574,다알리아헤어,1,1,1,3
4061,s1371414572,1371414572,성심머리사랑,1,1,1,3
4062,s38704622,38704622,머리대장,1,1,1,3
4063,s37433293,37433293,김송정머리터 명지대점,1,1,1,3
4064,s1732134469,1732134469,쿠니헤어,1,1,1,3
4065,s20844173,20844173,윤헤어,1,1,1,3
4066,s18231164,18231164,헤어꼬뜰레,1,1,1,3
4067,s21048604,21048604,TOP헤어갤러리 신내본점,1,1,1,3
4068,s1744469931,1744469931,양서연헤어샵,1,1,1,3
4069,s31392971,31392971,김도연헤어샾,1,1,1,3
4070,s1949447988,1949447988,폴리헤어,1,1,1,3
4071,s34349076,34349076,김명숙헤어갤러리,1,1,1,3
4072,s374837816,374837816,머리공간,1,1,1,3
4073,s1011554324,1011554324,유성미용실,1,1,1,3
4074,s1010102485,1010102485,로뎀헤어,1,1,1,3
4075,s20900297,20900297,미헤어,1,1,1,3
4076,s20851796,20851796,엘리시아헤어,1,1,1,3
4077,s1959855198,1959855198,양미용실,1,1,1,3
4078,s19416624,19416624,두발컷,1,1,1,3
4079,s18753297,18753297,스타헤어,1,1,1,3
4080,s1278243186,1278243186,친절한미용실,1,1,1,3
4081,s18198051,18198051,하니헤어라인,1,1,1,3
4082,s1386236095,1386236095,미광미용실,1,1,1,3
4083,s1052755497,1052755497,제이엔비헤어클럽,1,1,1,3
4084,s20915475,20915475,J&B미용실,1,1,1,3
4085,s1660717605,1660717605,T H헤어SHOP,1,1,1,3
4086,s1808147075,1808147075,써니스헤어,1,1,1,3
4087,s1694599623,1694599623,조이헤어,1,1,1,3
4088,s1140581383,1140581383,뿌띠앤뿌띠,1,1,1,3
4089,s20905690,20905690,빛나헤어샵,1,1,1,3
4090,s1295477634,1295477634,머리모양만들기,1,1,1,3
4091,s18756223,18756223,머리향기,1,1,1,3
4092,s1159946741,1159946741,살롱더Y,1,1,1,3
4093,s1735643986,1735643986,까미헤어,1,1,1,3
4094,s18879816,18879816,SS헤어,1,1,1,3
4095,s1857897973,1857897973,헤어나라,1,1,1,3
4096,s20826959,20826959,머리할시간,1,1,1,3
4097,s1313351282,1313351282,초대헤어,1,1,1,3
4098,s1884600245,1884600245,그라미헤어,1,1,1,3
4099,s20881446,20881446,김스헤어센스,1,1,1,3
4100,s1112353463,1112353463,태후사랑 중화1동점,1,1,1,3
4101,s1026415012,1026415012,나인헤어,1,1,1,3
4102,s37441521,37441521,준헤어,1,1,1,3
4103,s1741622905,1741622905,150헤어,1,1,1,3
4104,s20905503,20905503,강헤어샵,1,1,1,3
4105,s20913128,20913128,몽씨엘헤어,1,1,1,3
4106,s31395968,31395968,헤어스타미용실,1,1,1,3
4107,s20882851,20882851,머리사랑방,1,1,1,3
4108,s18756740,18756740,라벨르미용실,1,1,1,3
4109,s1838398390,1838398390,영화헤어,1,1,1,3
4110,s1094928710,1094928710,미니미장원,1,1,1,3
4111,s1141733300,1141733300,뷰티헤어,1,1,1,3
4112,s1428999072,1428999072,바바라샵헤어,1,1,1,3
4113,s1261781990,1261781990,시크헤어,1,1,1,3
4114,s1898690162,1898690162,머릿결사랑 면목점,1,1,1,3
4115,s31424732,31424732,티는헤어,1,1,1,3
4116,s18748473,18748473,모나리자미용실,1,1,1,3
4117,s1154623112,1154623112,헤어바이헤라,1,1,1,3
4118,s1037900680,1037900680,자르젠 헤어,1,1,1,3
4119,s20536495,20536495,두앤미헤어,1,1,1,3
4120,s1569723333,1569723333,살롱더맨,1,1,1,3
4121,s445146811,445146811,까끼헤어,1,1,1,3
4122,s36154598,36154598,라엘헤어,1,1,1,3
4123,s20832515,20832515,린헤어,1,1,1,3
4124,s31375667,31375667,12stay,1,1,1,3
4125,s1734722225,1734722225,54번가미용실,1,1,1,3
4126,s20099363,20099363,에프헤어살롱,1,1,1,3
4127,s20831930,20831930,준헤어라인,1,1,1,3
4128,s1249806840,1249806840,헤어스케치,1,1,1,3
4129,s1155277917,1155277917,동원미용실,1,1,1,3
4130,s1485341754,1485341754,늘솜머리,1,1,1,3
4131,s37568816,37568816,연조 미용실,1,1,1,3
4132,s1097926576,1097926576,응봉헤어라인,1,1,1,3
4133,s38344938,38344938,파트너헤어,1,1,1,3
4134,s1129825073,1129825073,W헤어,1,1,1,3
4135,s1217403206,1217403206,비비샵,1,1,1,3
4136,s38257037,38257037,살롱드 로사,1,1,1,3
4137,s11730080,11730080,블루클럽 마장역점,1,1,1,3
4138,s1531156447,1531156447,오땡큐 금호4가동점,1,1,1,3
4139,s20904207,20904207,김미선헤어존,1,1,1,3
4140,s1687262081,1687262081,산리쯔헤어 신금호점,1,1,1,3
4141,s38492891,38492891,헬로우컷 성수역점,1,1,1,3
4142,s20877503,20877503,그린헤어,1,1,1,3
4143,s1908572551,1908572551,이나현헤어,1,1,1,3
4144,s1250764372,1250764372,소현미용실,1,1,1,3
4145,s37642114,37642114,앙포레모리노헤어 뚝섬점,1,1,1,3
4146,s836711131,836711131,김도경헤어,1,1,1,3
4147,s502846512,502846512,태임헤어,1,1,1,3
4148,s1652334986,1652334986,큐사랑염색방,1,1,1,3
4149,s20115007,20115007,장스헤어,1,1,1,3
4150,s36161298,36161298,엘린헤어,1,1,1,3
4151,s1757553161,1757553161,세련헤어,1,1,1,3
4152,s1720642300,1720642300,정미용실,1,1,1,3
4153,s1633893717,1633893717,한나헤어살롱,1,1,1,3
4154,s1562874856,1562874856,블루클럽 상왕십리뉴타운점,1,1,1,3
4155,s36459984,36459984,블루클럽상왕십리뉴타운점,1,1,1,3
4156,s1966287946,1966287946,머리하는날,1,1,1,3
4157,s33118761,33118761,유희정헤어스토리,1,1,1,3
4158,s37249536,37249536,헤어바이홍,1,1,1,3
4159,s1231500288,1231500288,박종숙헤어샵,1,1,1,3
4160,s20907918,20907918,샤인헤어,1,1,1,3
4161,s1743550935,1743550935,태후사랑중화2동점,1,1,1,3
4162,s37197351,37197351,제이헤어,1,1,1,3
4163,s37162526,37162526,가랑헤어살롱,1,1,1,3
4164,s1073420697,1073420697,코코헤어,1,1,1,3
4165,s120584512,120584512,로쏘헤어,1,1,1,3
4166,s18837629,18837629,호수미용실,1,1,1,3
4167,s1593312029,1593312029,헤드워크 어샌틱 컷츠,1,1,1,3
4168,s35112108,35112108,남성컷트타임 뚝섬역점,1,1,1,3
4169,s1323401617,1323401617,태후사랑성수2가점,1,1,1,3
4170,s1057230242,1057230242,머리하는날,1,1,1,3
4171,s1616335925,1616335925,승민살롱,1,1,1,3
4172,s1491790311,1491790311,리샤살롱,1,1,1,3
4173,s1334637437,1334637437,조헤어샵,1,1,1,3
4174,s1592520263,1592520263,맵시헤어,1,1,1,3
4175,s20838769,20838769,헤어명작,1,1,1,3
4176,s20834771,20834771,단발머리,1,1,1,3
4177,s1112621265,1112621265,헤어솔루션,1,1,1,3
4178,s33305786,33305786,구피샵 망우점,1,1,1,3
4179,s1504998870,1504998870,미소헤어,1,1,1,3
4180,s1563815980,1563815980,본헤어,1,1,1,3
4181,s1243849346,1243849346,비타민헤어,1,1,1,3
4182,s1294451432,1294451432,라비제헤어,1,1,1,3
4183,s1259133457,1259133457,바이유헤어,1,1,1,3
4184,s1865526968,1865526968,박진헤어뷰,1,1,1,3
4185,s20839940,20839940,제씨,1,1,1,3
4186,s18823719,18823719,정해진헤어갤러리,1,1,1,3
4187,s189506387,189506387,동네미장원,1,1,1,3
4188,s1033639862,1033639862,비바샵,1,1,1,3
4189,s1235413449,1235413449,현미헤어샵,1,1,1,3
4190,s38705488,38705488,MY HAIR샵,1,1,1,3
4191,s34098816,34098816,김정숙헤어아트,1,1,1,3
4192,s1300197009,1300197009,샬롱드9,1,1,1,3
4193,s1808604886,1808604886,현경헤어,1,1,1,3
4194,s158945653,158945653,안녕수아살롱,1,1,1,3
4195,s1955820247,1955820247,이훈ALL30000 답십리역점,1,1,1,3
4196,s712552601,712552601,나이스가이 왕십리뉴타운점,1,1,1,3
4197,s32434850,32434850,강성범헤어,1,1,1,3
4198,s1108201116,1108201116,우디바버샵,1,1,1,3
4199,s31396770,31396770,머리헤어,1,1,1,3
4200,s20857555,20857555,머리세상,1,1,1,3
4201,s1241157667,1241157667,안혜리미용실,1,1,1,3
4202,s191018054,191018054,세움헤어,1,1,1,3
4203,s1352612533,1352612533,헤어투데이,1,1,1,3
4204,s389204377,389204377,서현헤어,1,1,1,3
4205,s1272125244,1272125244,새영헤어,1,1,1,3
4206,s1821776629,1821776629,보리쌀롱,1,1,1,3
4207,s1353904701,1353904701,상상헤어샵,1,1,1,3
4208,s1506436234,1506436234,도쿄인헤어,1,1,1,3
4209,s1916269041,1916269041,헤어살롱코라,1,1,1,3
4210,s1647451075,1647451075,탑헤어클럽,1,1,1,3
4211,s37253901,37253901,사랑헤어,1,1,1,3
4212,s1462205326,1462205326,제이헤어,1,1,1,3
4213,s20926680,20926680,벨팜므헤어,1,1,1,3
4214,s1149025711,1149025711,프리티헤어샵,1,1,1,3
4215,s37895829,37895829,헤어6,1,1,1,3
4216,s1793943551,1793943551,금란헤어샵,1,1,1,3
4217,s21647019,21647019,헤어멜로즈,1,1,1,3
4218,s20822386,20822386,강헤어샵,1,1,1,3
4219,s20673797,20673797,블루클럽 성수역점,1,1,1,3
4220,s1174928418,1174928418,헤라미용실,1,1,1,3
4221,s1375799007,1375799007,금란헤어샵,1,1,1,3
4222,s1525117180,1525117180,가인헤어,1,1,1,3
4223,s1434767806,1434767806,이우진헤어뱅크,1,1,1,3
4224,s20050204,20050204,샤이닝 헤어,1,1,1,3
4225,s35756765,35756765,은헤어,1,1,1,3
4226,s1600087766,1600087766,헤어코디,1,1,1,3
4227,s11730091,11730091,블루클럽 응봉점,1,1,1,3
4228,s1431822326,1431822326,라피네헤어,1,1,1,3
4229,s1075705423,1075705423,아뜰리에H헤어,1,1,1,3
4230,s18797706,18797706,하미헤어,1,1,1,3
4231,s1777926839,1777926839,다온헤어,1,1,1,3
4232,s20907551,20907551,리브가헤어샵,1,1,1,3
4233,s1308289412,1308289412,명희헤어,1,1,1,3
4234,s1530041451,1530041451,헤어스케치,1,1,1,3
4235,s20853700,20853700,헤어샵티파니,1,1,1,3
4236,s1904398774,1904398774,예스헤어필,1,1,1,3
4237,s31424517,31424517,2L Story,1,1,1,3
4238,s1493776507,1493776507,뮤즈헤어,1,1,1,3
4239,s20903438,20903438,패밀리헤어,1,1,1,3
4240,s34052662,34052662,JJ헤어,1,1,1,3
4241,s20865110,20865110,앙포레헤어샵,1,1,1,3
4242,s32910708,32910708,라스트헤어,1,1,1,3
4243,s34100850,34100850,마벨헤어,1,1,1,3
4244,s1544835950,1544835950,루나헤어,1,1,1,3
4245,s1009322302,1009322302,라니헤어,1,1,1,3
4246,s629002108,629002108,세븐헤어,1,1,1,3
4247,s1537924878,1537924878,수미용실,1,1,1,3
4248,s1001733488,1001733488,로드헤어,1,1,1,3
4249,s1471344943,1471344943,압구정SS헤어클리닉,1,1,1,3
4250,s36399110,36399110,마이두헤어,1,1,1,3
4251,s33210283,33210283,일오공헤어,1,1,1,3
4252,s35178450,35178450,퀸즈헤나,1,1,1,3
4253,s1245423971,1245423971,봄헤어,1,1,1,3
4254,s1482962972,1482962972,수헤어,1,1,1,3
4255,s1904851935,1904851935,헤어비타민,1,1,1,3
4256,s34191355,34191355,헤어플랜J,1,1,1,3
4257,s35744070,35744070,썬헤어,1,1,1,3
4258,s32800233,32800233,한스미용실,1,1,1,3
4259,s20842004,20842004,가영헤어,1,1,1,3
4260,s1510384360,1510384360,차밍헤어,1,1,1,3
4261,s1572038534,1572038534,시크헤어,1,1,1,3
4262,s1427030154,1427030154,브릿지헤어,1,1,1,3
4263,s31507335,31507335,MS헤어,1,1,1,3
4264,s1735316329,1735316329,덤앤더머,1,1,1,3
4265,s1344847674,1344847674,쎄븐헤어,1,1,1,3
4266,s1761513878,1761513878,가비헤어,1,1,1,3
4267,s1070144783,1070144783,다미헤어,1,1,1,3
4268,s1630605527,1630605527,옻안타는천연염색,1,1,1,3
4269,s37568977,37568977,ADAMAS,1,1,1,3
4270,s37155391,37155391,설레임,1,1,1,3
4271,s17911400,17911400,미세스주머리방,1,1,1,3
4272,s36353908,36353908,만원의행복,1,1,1,3
4273,s1132987656,1132987656,고은헤어,1,1,1,3
4274,s1082278726,1082278726,멋머리방,1,1,1,3
4275,s20888914,20888914,애림미용실,1,1,1,3
4276,s34581877,34581877,조민헤어,1,1,1,3
4277,s1982246476,1982246476,소프레사 헤어살롱,1,1,1,3
4278,s1983435652,1983435652,원미용실,1,1,1,3
4279,s1303804730,1303804730,옻안타는천연염색 행당점,1,1,1,3
4280,s1277370499,1277370499,헤어샵426,1,1,1,3
4281,s441343412,441343412,썬헤어,1,1,1,3
4282,s37936258,37936258,라온헤어,1,1,1,3
4283,s1858320820,1858320820,김태영헤어,1,1,1,3
4284,s36305167,36305167,머리놀이터,1,1,1,3
4285,s36260510,36260510,정원헤어,1,1,1,3
4286,s1446662933,1446662933,머리사랑,1,1,1,3
4287,s18914085,18914085,김경자헤어아트,1,1,1,3
4288,s1966627819,1966627819,이끌람헤어,1,1,1,3
4289,s20943068,20943068,정미용실,1,1,1,3
4290,s1849358966,1849358966,김연화헤어,1,1,1,3
4291,s1353660343,1353660343,채린헤어,1,1,1,3
4292,s18914426,18914426,모드미용실,1,1,1,3
4293,s1682942611,1682942611,여림헤어,1,1,1,3
4294,s20835791,20835791,단비미용실,1,1,1,3
4295,s20923990,20923990,란이네헤어,1,1,1,3
4296,s1429321836,1429321836,미다몬헤어 미아현대점,1,1,1,3
4297,s1604814608,1604814608,사쿠토헤어월곡점,1,1,1,3
4298,s20843439,20843439,제이헤어,1,1,1,3
4299,s1851767461,1851767461,오미나미용실,1,1,1,3
4300,s34345759,34345759,데쌩드남희프리미엄헤어살롱,1,1,1,3
4301,s20912558,20912558,오드리,1,1,1,3
4302,s18258380,18258380,머리깎자,1,1,1,3
4303,s36792382,36792382,헤어별네일,1,1,1,3
4304,s1811897958,1811897958,서울미용실,1,1,1,3
4305,s20889684,20889684,머리하기좋은날,1,1,1,3
4306,s20935387,20935387,헤어칼리지,1,1,1,3
4307,s20862892,20862892,Satin길음뉴타운점,1,1,1,3
4308,s20920079,20920079,블루헤어샵,1,1,1,3
4309,s1813913085,1813913085,정미용실,1,1,1,3
4310,s33252634,33252634,머리어때,1,1,1,3
4311,s20854961,20854961,이정민미용실,1,1,1,3
4312,s20878422,20878422,머리방미용실,1,1,1,3
4313,s1823076953,1823076953,선헤어샵,1,1,1,3
4314,s20915413,20915413,연주헤어,1,1,1,3
4315,s36481587,36481587,끌레오헤어,1,1,1,3
4316,s20878462,20878462,아오야마,1,1,1,3
4317,s20827878,20827878,연미용실,1,1,1,3
4318,s765685781,765685781,이지헤어,1,1,1,3
4319,s37642167,37642167,The 샹뜨 by 김은주,1,1,1,3
4320,s20823827,20823827,김영애헤어갤러리,1,1,1,3
4321,s1605268722,1605268722,글로리헤어,1,1,1,3
4322,s18918206,18918206,마실미용실,1,1,1,3
4323,s18265985,18265985,다래미용실,1,1,1,3
4324,s1259813679,1259813679,다래헤어샵,1,1,1,3
4325,s18240376,18240376,김자경미용실,1,1,1,3
4326,s31538039,31538039,랑이헤어샵,1,1,1,3
4327,s18227477,18227477,미스타송헤어뉴스,1,1,1,3
4328,s13412514,13412514,더스타일 미용실,1,1,1,3
4329,s1352348077,1352348077,정숙미용실,1,1,1,3
4330,s18898485,18898485,까끌래뽁끌래,1,1,1,3
4331,s18915825,18915825,수현미용실,1,1,1,3
4332,s20905153,20905153,황선화헤어살롱,1,1,1,3
4333,s18919063,18919063,미혜헤어탑,1,1,1,3
4334,s18896624,18896624,지은미용실,1,1,1,3
4335,s18899893,18899893,가든미용실,1,1,1,3
4336,s20869168,20869168,미림미용실,1,1,1,3
4337,s18900986,18900986,참미용실,1,1,1,3
4338,s1040173188,1040173188,미림헤어,1,1,1,3
4339,s18901139,18901139,홍미용실,1,1,1,3
4340,s18280964,18280964,윤미용실,1,1,1,3
4341,s1062384977,1062384977,1007헤어,1,1,1,3
4342,s20901222,20901222,까꼬뽀꼬헤어샵,1,1,1,3
4343,s1909522421,1909522421,제이제이헤어,1,1,1,3
4344,s18913054,18913054,아름미용실,1,1,1,3
4345,s38282315,38282315,퀸즈프린스,1,1,1,3
4346,s18912963,18912963,손민정헤어샵,1,1,1,3
4347,s20866760,20866760,쎄느미용실,1,1,1,3
4348,s20916297,20916297,이현주샵,1,1,1,3
4349,s20939262,20939262,진아미용실,1,1,1,3
4350,s1536066214,1536066214,수연뷰티살롱,1,1,1,3
4351,s20916412,20916412,선경아헤어,1,1,1,3
4352,s1211354020,1211354020,머리사랑샵,1,1,1,3
4353,s20930774,20930774,깜헤어갤러리,1,1,1,3
4354,s1021191324,1021191324,애드플러스미용실,1,1,1,3
4355,s36860163,36860163,감각헤어,1,1,1,3
4356,s20924072,20924072,미가헤어,1,1,1,3
4357,s20939193,20939193,오고파미용실,1,1,1,3
4358,s18212922,18212922,조희미용실,1,1,1,3
4359,s18909045,18909045,산호미용실,1,1,1,3
4360,s18912495,18912495,백합미용실,1,1,1,3
4361,s18226009,18226009,제일미용실,1,1,1,3
4362,s20271711,20271711,백합미용실,1,1,1,3
4363,s1213450399,1213450399,머리사랑,1,1,1,3
4364,s1517093116,1517093116,사랑미용실,1,1,1,3
4365,s12076309,12076309,BN4헤어살롱,1,1,1,3
4366,s1562837963,1562837963,데이지헤어,1,1,1,3
4367,s1742868456,1742868456,여우머리,1,1,1,3
4368,s1760140294,1760140294,시아헤어,1,1,1,3
4369,s1538425006,1538425006,미장원 by문주,1,1,1,3
4370,s33824261,33824261,김도경헤어,1,1,1,3
4371,s36224819,36224819,예지원헤어,1,1,1,3
4372,s35743006,35743006,칼라미용실,1,1,1,3
4373,s18906190,18906190,예은헤어뷰티,1,1,1,3
4374,s20882345,20882345,빼어날수헤어샵,1,1,1,3
4375,s13226772,13226772,헤어데이스,1,1,1,3
4376,s20866745,20866745,샘미용실,1,1,1,3
4377,s18922060,18922060,수민미용실,1,1,1,3
4378,s1625563390,1625563390,머리사랑,1,1,1,3
4379,s20905077,20905077,머리꽃,1,1,1,3
4380,s1267861065,1267861065,실버전용 미용실 5080,1,1,1,3
4381,s1475145531,1475145531,라인헤어샵,1,1,1,3
4382,s1116004618,1116004618,샬롬미용실,1,1,1,3
4383,s20847545,20847545,선영아머리해,1,1,1,3
4384,s20855003,20855003,차명화헤어샵,1,1,1,3
4385,s20882324,20882324,중앙미용실,1,1,1,3
4386,s36462676,36462676,준헤어샵,1,1,1,3
4387,s20882320,20882320,신진미용실,1,1,1,3
4388,s20843437,20843437,강미용실,1,1,1,3
4389,s35913532,35913532,바니헤어,1,1,1,3
4390,s1116343522,1116343522,올림픽미용실,1,1,1,3
4391,s1372101685,1372101685,정아미용실,1,1,1,3
4392,s1686140888,1686140888,해바헤어,1,1,1,3
4393,s1987861860,1987861860,코코헤어,1,1,1,3
4394,s35209432,35209432,헤어살롱느낌,1,1,1,3
4395,s18889580,18889580,코코헤어,1,1,1,3
4396,s20874316,20874316,정유리헤어크리닉,1,1,1,3
4397,s1006857149,1006857149,홍스헤어,1,1,1,3
4398,s20920144,20920144,제이미용실,1,1,1,3
4399,s1019802384,1019802384,세븐미용실,1,1,1,3
4400,s526632145,526632145,머리헤어,1,1,1,3
4401,s1675413038,1675413038,연우헤어,1,1,1,3
4402,s20943212,20943212,소희헤어뉴스,1,1,1,3
4403,s18923689,18923689,송죽미용실,1,1,1,3
4404,s1232373096,1232373096,헤어컬엑스,1,1,1,3
4405,s18923897,18923897,대호미용실,1,1,1,3
4406,s1909206092,1909206092,현헤어갤러리,1,1,1,3
4407,s18923381,18923381,헤어아트,1,1,1,3
4408,s20897388,20897388,현헤어,1,1,1,3
4409,s20851305,20851305,예진헤어샵,1,1,1,3
4410,s20908968,20908968,리즈미용실,1,1,1,3
4411,s20938380,20938380,선미용실,1,1,1,3
4412,s1874333916,1874333916,샤론미용실,1,1,1,3
4413,s18304015,18304015,엠티미용실,1,1,1,3
4414,s1398540279,1398540279,최정애헤어클럽,1,1,1,3
4415,s1591334039,1591334039,보그헤어,1,1,1,3
4416,s20839701,20839701,루나헤어,1,1,1,3
4417,s1206008495,1206008495,세븐헤어,1,1,1,3
4418,s1059775124,1059775124,머리사랑미용실,1,1,1,3
4419,s20870524,20870524,은미헤어,1,1,1,3
4420,s20943026,20943026,헤어스토리,1,1,1,3
4421,s1721670365,1721670365,세이프존미용실,1,1,1,3
4422,s20832028,20832028,종로미용실,1,1,1,3
4423,s18923703,18923703,승민헤어,1,1,1,3
4424,s20843694,20843694,경아미용실,1,1,1,3
4425,s37549130,37549130,큐사랑 염색,1,1,1,3
4426,s19412150,19412150,티지헤어,1,1,1,3
4427,s13204003,13204003,움헤어,1,1,1,3
4428,s1650469704,1650469704,까망머리 석관점,1,1,1,3
4429,s20843465,20843465,미가노픈헤어,1,1,1,3
4430,s20884697,20884697,온리맨,1,1,1,3
4431,s20930316,20930316,머리할래요헤어클럽,1,1,1,3
4432,s19769196,19769196,다모아헤어살롱,1,1,1,3
4433,s17889551,17889551,현미프로헤어,1,1,1,3
4434,s17901032,17901032,주헤어,1,1,1,3
4435,s20876825,20876825,헤어갤러리,1,1,1,3
4436,s36086775,36086775,이소정헤어,1,1,1,3
4437,s1666293809,1666293809,미용실김수희,1,1,1,3
4438,s1682363259,1682363259,김유리리더헤어,1,1,1,3
4439,s11597903,11597903,휠헤어샵,1,1,1,3
4440,s18768924,18768924,행복을주는미용실,1,1,1,3
4441,s1581679992,1581679992,헤어갤러리,1,1,1,3
4442,s20926389,20926389,루디아헤어클럽,1,1,1,3
4443,s18779218,18779218,성장미용실,1,1,1,3
4444,s17900400,17900400,승애미용실,1,1,1,3
4445,s1222161257,1222161257,은주미용실,1,1,1,3
4446,s20828449,20828449,장헤어클럽,1,1,1,3
4447,s1795514186,1795514186,바란미용실,1,1,1,3
4448,s1428798300,1428798300,하수정미용실,1,1,1,3
4449,s17910598,17910598,코스모스미용실,1,1,1,3
4450,s17889555,17889555,이수정미용실,1,1,1,3
4451,s20896021,20896021,행당미용타운,1,1,1,3
4452,s17900417,17900417,새순미용실,1,1,1,3
4453,s1282486922,1282486922,부띠아베끄,1,1,1,3
4454,s36658244,36658244,최헤어,1,1,1,3
4455,s20861870,20861870,가인헤어,1,1,1,3
4456,s20926998,20926998,혜리미헤어,1,1,1,3
4457,s37333624,37333624,붐헤어&메이크업,1,1,1,3
4458,s19381865,19381865,마이헤어샵 행당점,1,1,1,3
4459,s19713278,19713278,마이헤어샵 왕십리점,1,1,1,3
4460,s37463890,37463890,구피샵 행당점,1,1,1,3
4461,s1502273396,1502273396,가인헤어펌,1,1,1,3
4462,s36005274,36005274,주노헤어숍,1,1,1,3
4463,s1182968621,1182968621,대림헤어모드,1,1,1,3
4464,s20914982,20914982,토마토행당점,1,1,1,3
4465,s17889558,17889558,은하미용실,1,1,1,3
4466,s1014634605,1014634605,세연머리왕국,1,1,1,3
4467,s11738707,11738707,이수영미용실,1,1,1,3
4468,s19753960,19753960,헤어살롱B&G 행당역점,1,1,1,3
4469,s38780429,38780429,신라머리방,1,1,1,3
4470,s1100744608,1100744608,청한미용실,1,1,1,3
4471,s18781004,18781004,행복미용실,1,1,1,3
4472,s17891385,17891385,성은미용실,1,1,1,3
4473,s20861261,20861261,명동미용실,1,1,1,3
4474,s17892645,17892645,태양미용실,1,1,1,3
4475,s20915524,20915524,제일미용실,1,1,1,3
4476,s20938090,20938090,청담동미용실,1,1,1,3
4477,s1026584173,1026584173,귀빈미용실,1,1,1,3
4478,s20941753,20941753,다성헤어샵,1,1,1,3
4479,s20838536,20838536,오렌지헤어샵,1,1,1,3
4480,s20914945,20914945,박은선미용실,1,1,1,3
4481,s66737640,66737640,행운미장원,1,1,1,3
4482,s18780083,18780083,연정헤어뱅크,1,1,1,3
4483,s17909720,17909720,선헤어랜드,1,1,1,3
4484,s1256106233,1256106233,진헤어샵,1,1,1,3
4485,s17945862,17945862,진미용실,1,1,1,3
4486,s1611523890,1611523890,황태자미용실,1,1,1,3
4487,s1542060983,1542060983,수경헤어샵,1,1,1,3
4488,s17892650,17892650,헤어포인트,1,1,1,3
4489,s35856618,35856618,규리미용실,1,1,1,3
4490,s20899684,20899684,현대미용실,1,1,1,3
4491,s17892981,17892981,박준헤어,1,1,1,3
4492,s20834543,20834543,준헤어아트,1,1,1,3
4493,s1445118232,1445118232,팔방미인미용실,1,1,1,3
4494,s18798971,18798971,채미용실,1,1,1,3
4495,s1853538595,1853538595,정아미용실,1,1,1,3
4496,s20342073,20342073,까꼬뽀꼬헤어,1,1,1,3
4497,s1791353275,1791353275,인디헤어,1,1,1,3
4498,s1509793205,1509793205,써니헤어클리닉사가정점,1,1,1,3
4499,s1788663102,1788663102,박희숙미용실,1,1,1,3
4500,s1381698944,1381698944,머리공화국,1,1,1,3
4501,s1751559707,1751559707,머리풍경,1,1,1,3
4502,s85999188,85999188,E 미장원,1,1,1,3
4503,s1927892201,1927892201,조민헤어,1,1,1,3
4504,s1253251545,1253251545,헤어짱,1,1,1,3
4505,s1908694597,1908694597,조민헤어,1,1,1,3
4506,s1755071625,1755071625,유노헤어,1,1,1,3
4507,s1004228121,1004228121,민헤어,1,1,1,3
4508,s20853991,20853991,경희헤어타운,1,1,1,3
4509,s1361814872,1361814872,춤추는가위,1,1,1,3
4510,s1871653560,1871653560,박지민헤어,1,1,1,3
4511,s19542686,19542686,블랑쉬노엘헤어살롱,1,1,1,3
4512,s18341738,18341738,블루클럽 남부터미널점,1,1,1,3
4513,s1445588395,1445588395,코코헤어,1,1,1,3
4514,s624199067,624199067,드보르,1,1,1,3
4515,sk1607191643,k1607191643,화영헤어,1,1,1,3
4516,sk18364229,k18364229,강서이발관,1,1,1,3
4517,s230380187,230380187,수연미용실,1,1,1,3
4518,s36475971,36475971,수연뷰티랩,1,1,1,3
4519,s35447300,35447300,유앤아이,1,1,1,3
4520,s36272925,36272925,머리향기,1,1,1,3
4521,s1943916232,1943916232,서초미용실,1,1,1,3
4522,s18323709,18323709,장원자헤어아트,1,1,1,3
4523,s1654394698,1654394698,앨빈 헤어살롱,1,1,1,3
4524,s1700124476,1700124476,살롱드  Y,1,1,1,3
4525,s1530876395,1530876395,퀸즈헤나 방배점,1,1,1,3
4526,s11729986,11729986,블루클럽 교대점,1,1,1,3
4527,s1062263400,1062263400,제이헤어 아틀리에,1,1,1,3
4528,s38223335,38223335,벨꾸르헤어 양재점,1,1,1,3
4529,s1669009969,1669009969,style by j hair,1,1,1,3
4530,s1345326728,1345326728,더봄헤어,1,1,1,3
4531,s20628667,20628667,카라헤어,1,1,1,3
4532,s20886375,20886375,가위소리헤어샵,1,1,1,3
4533,s1900546937,1900546937,미즈헤어,1,1,1,3
4534,s330792793,330792793,헤어락,1,1,1,3
4535,s1283828065,1283828065,꽃미용실,1,1,1,3
4536,s1344762336,1344762336,헤세드헤어,1,1,1,3
4537,s1568643820,1568643820,은영헤어샵,1,1,1,3
4538,s18201524,18201524,희진미용타운,1,1,1,3
4539,s18200195,18200195,동화미용실,1,1,1,3
4540,s1262139487,1262139487,hair aA,1,1,1,3
4541,s18295894,18295894,샤론헤어살롱,1,1,1,3
4542,s1859963888,1859963888,오헤어,1,1,1,3
4543,s1383617374,1383617374,살롱디케이,1,1,1,3
4544,s1748194761,1748194761,살롱 드 라움 부티끄,1,1,1,3
4545,s37229900,37229900,홍헤어,1,1,1,3
4546,s1071689110,1071689110,미넷,1,1,1,3
4547,s20926682,20926682,우리헤어,1,1,1,3
4548,sk1429707028,k1429707028,김은제헤어,1,1,1,3
4549,s1279860219,1279860219,H731 hair,1,1,1,3
4550,s1403102176,1403102176,라우레아,1,1,1,3
4551,s1309117356,1309117356,나이스가이 신논현역점,1,1,1,3
4552,s1231012172,1231012172,헤어코코,1,1,1,3
4553,s1526549271,1526549271,1층헤어,1,1,1,3
4554,s1176036713,1176036713,라라헤어,1,1,1,3
4555,s1573514915,1573514915,나이스가이 서초우면점,1,1,1,3
4556,sk1478904254,k1478904254,에쓰비해어,1,1,1,3
4557,s1158888229,1158888229,주헤어아트,1,1,1,3
4558,s20861832,20861832,프로헤어샵,1,1,1,3
4559,s1323403162,1323403162,나인헤어,1,1,1,3
4560,s20834132,20834132,선미용실,1,1,1,3
4561,s17900408,17900408,흙미용실,1,1,1,3
4562,s1661822282,1661822282,김용희헤어,1,1,1,3
4563,s1567998654,1567998654,아담미용실,1,1,1,3
4564,s18736739,18736739,김선영헤어,1,1,1,3
4565,s1312042650,1312042650,허인숙더헤어,1,1,1,3
4566,s1590103662,1590103662,지인헤어,1,1,1,3
4567,s268965936,268965936,더봄헤어,1,1,1,3
4568,s1363653855,1363653855,스타일랩,1,1,1,3
4569,s417447714,417447714,뉴헤어,1,1,1,3
4570,s18776004,18776004,코코헤어,1,1,1,3
4571,s37127237,37127237,차세미헤어,1,1,1,3
4572,s1472605812,1472605812,노블헤어,1,1,1,3
4573,s1849565873,1849565873,단아미용실,1,1,1,3
4574,s1107259800,1107259800,헤어청,1,1,1,3
4575,s1115800264,1115800264,오라헤어살롱,1,1,1,3
4576,s1704040234,1704040234,쥬노미용실,1,1,1,3
4577,s1052036206,1052036206,스튜디오 꿈,1,1,1,3
4578,s1295309100,1295309100,에이치누보헤어,1,1,1,3
4579,s1704379016,1704379016,르띠뷰티헤어,1,1,1,3
4580,s67528857,67528857,팜스헤어,1,1,1,3
4581,s1877801845,1877801845,쓰리컴피,1,1,1,3
4582,s1745405563,1745405563,알파파르프 밀라노,1,1,1,3
4583,s18774628,18774628,동명미용실,1,1,1,3
4584,s20911063,20911063,경일헤어코디,1,1,1,3
4585,s18780747,18780747,인애미용실,1,1,1,3
4586,s20865261,20865261,아까르마,1,1,1,3
4587,s20846216,20846216,컷트클럽,1,1,1,3
4588,s20933964,20933964,헤어보그,1,1,1,3
4589,s1345070480,1345070480,헤어펠리스,1,1,1,3
4590,s12984990,12984990,헤어스타일 헤어벨,1,1,1,3
4591,s20819796,20819796,G2헤어,1,1,1,3
4592,s1300796044,1300796044,헤어오르블랑,1,1,1,3
4593,s1551247951,1551247951,헤어엘,1,1,1,3
4594,s1460300984,1460300984,이상희헤어팝금호점,1,1,1,3
4595,s31394348,31394348,머리하는날,1,1,1,3
4596,s17911397,17911397,지훈헤어,1,1,1,3
4597,s36091085,36091085,청담헤어,1,1,1,3
4598,s20930826,20930826,코코미용실,1,1,1,3
4599,s1280761411,1280761411,라니쌤헤어,1,1,1,3
4600,s33279843,33279843,구피샵 금호점,1,1,1,3
4601,s1330203853,1330203853,카르마헤어,1,1,1,3
4602,s1240377561,1240377561,티나헤어,1,1,1,3
4603,s17909708,17909708,신명기헤어라인,1,1,1,3
4604,s1354467427,1354467427,루디아미용실,1,1,1,3
4605,s1234290672,1234290672,킴스헤어클럽,1,1,1,3
4606,s37932514,37932514,청춘시대,1,1,1,3
4607,s31398237,31398237,문선영미용실,1,1,1,3
4608,s32873966,32873966,마즈헤어,1,1,1,3
4609,s1442345066,1442345066,철수미용실,1,1,1,3
4610,s1535942359,1535942359,상투틀고댕기따고,1,1,1,3
4611,s31531190,31531190,은하미용실,1,1,1,3
4612,s20840108,20840108,으뜸머리방,1,1,1,3
4613,s20914968,20914968,김미현헤어,1,1,1,3
4614,s20918540,20918540,손소영헤어샵,1,1,1,3
4615,s1304580327,1304580327,고운님헤어크리닉,1,1,1,3
4616,s11694775,11694775,유경 헤어라운지,1,1,1,3
4617,s17900392,17900392,여정헤어샵,1,1,1,3
4618,s20857467,20857467,기지미용실,1,1,1,3
4619,s1486285881,1486285881,김헤어라인,1,1,1,3
4620,s1289702853,1289702853,김미용실,1,1,1,3
4621,s1155541252,1155541252,헤어 바이 이지은,1,1,1,3
4622,s31658416,31658416,똥머리헤어,1,1,1,3
4623,s38248648,38248648,청춘만발 본점,1,1,1,3
4624,s20880841,20880841,가위소리,1,1,1,3
4625,s11637315,11637315,명화 헤어저널,1,1,1,3
4626,s17925192,17925192,김민헤어갤러리,1,1,1,3
4627,s17904964,17904964,이호철머리도사,1,1,1,3
4628,s1566504443,1566504443,칼리미용실,1,1,1,3
4629,s20919066,20919066,김은경헤어라인,1,1,1,3
4630,s1733041599,1733041599,머리나라,1,1,1,3
4631,s1111814058,1111814058,김현희뷰티클럽,1,1,1,3
4632,s20888175,20888175,시티헤어샵,1,1,1,3
4633,s1297437088,1297437088,헤어매니아,1,1,1,3
4634,s18779738,18779738,디오헤어아트,1,1,1,3
4635,s11730088,11730088,블루클럽 옥수점,1,1,1,3
4636,s13395236,13395236,이훈헤어칼라 금호점,1,1,1,3
4637,s11694763,11694763,헤어홀릭 미용실,1,1,1,3
4638,s17889554,17889554,버르장머리,1,1,1,3
4639,s31394634,31394634,맨투맨남성헤어컷,1,1,1,3
4640,s11730072,11730072,블루클럽 답십리점,1,1,1,3
4641,s18779505,18779505,유경희미용실,1,1,1,3
4642,s38705231,38705231,일 살로네,1,1,1,3
4643,s17917196,17917196,헤어짱미용실,1,1,1,3
4644,s20892523,20892523,최신머리방,1,1,1,3
4645,s20919026,20919026,다인헤어,1,1,1,3
4646,s20830760,20830760,BELLE,1,1,1,3
4647,s1176174451,1176174451,헤라뷰티헤어,1,1,1,3
4648,s20838227,20838227,최원준미용실,1,1,1,3
4649,s1932813811,1932813811,임마누엘미용실,1,1,1,3
4650,s37446150,37446150,가위소리,1,1,1,3
4651,s625256719,625256719,아랑헤어모드본점,1,1,1,3
4652,s20930228,20930228,옥수미용실,1,1,1,3
4653,s1932712479,1932712479,압구정프로헤어,1,1,1,3
4654,s1646327813,1646327813,드림헤어,1,1,1,3
4655,s20826516,20826516,블루클럽행담점,1,1,1,3
4656,sk36334569,k36334569,블루클럽,1,1,1,3
4657,s20880821,20880821,김하영뷰티,1,1,1,3
4658,s1408403505,1408403505,박유진헤어샾,1,1,1,3
4659,s1576369228,1576369228,청춘머리방,1,1,1,3
4660,s31222382,31222382,청춘플러스쁘띠,1,1,1,3
4661,s19418813,19418813,영미용실,1,1,1,3
4662,s1919218432,1919218432,민들레헤어샵,1,1,1,3
4663,s17891387,17891387,라리윤 헤어샵,1,1,1,3
4664,s18776657,18776657,챠밍헤어센스,1,1,1,3
4665,s20684155,20684155,호수미용실,1,1,1,3
4666,s1561213106,1561213106,수연미용실,1,1,1,3
4667,s20832377,20832377,수연미용실,1,1,1,3
4668,s18772286,18772286,숙미용실,1,1,1,3
4669,s17933419,17933419,남미용실,1,1,1,3
4670,s18798838,18798838,세아미용실,1,1,1,3
4671,s20822292,20822292,헤어이공사,1,1,1,3
4672,s20907530,20907530,윤경헤어삽,1,1,1,3
4673,s11562225,11562225,세라 헤어클럽,1,1,1,3
4674,s1003679076,1003679076,자이안헤어,1,1,1,3
4675,s1436219941,1436219941,쿠키헤어,1,1,1,3
4676,s20903925,20903925,헤어도로시,1,1,1,3
4677,s1387169770,1387169770,장미용실,1,1,1,3
4678,s1303475289,1303475289,조희미용타운,1,1,1,3
4679,s1253522427,1253522427,궁전헤어라인,1,1,1,3
4680,s1637056191,1637056191,제이쿠도,1,1,1,3
4681,s1740649163,1740649163,헤어박스미용실 성수점,1,1,1,3
4682,s1873123800,1873123800,영미용실,1,1,1,3
4683,s1033050625,1033050625,단형헤어,1,1,1,3
4684,s20885001,20885001,세리헤어센스,1,1,1,3
4685,s20826638,20826638,고우니헤어,1,1,1,3
4686,s36005275,36005275,현미용실,1,1,1,3
4687,s17912542,17912542,고명옥미용실,1,1,1,3
4688,s20412594,20412594,진미용실,1,1,1,3
4689,s17941437,17941437,강은미장,1,1,1,3
4690,s1369453522,1369453522,정들러미용실,1,1,1,3
4691,s37683203,37683203,크리스탈 살롱,1,1,1,3
4692,s17904970,17904970,가원미용실,1,1,1,3
4693,s18769917,18769917,임은경헤어샵,1,1,1,3
4694,s1125154690,1125154690,펌앤펌헤어,1,1,1,3
4695,s1548174048,1548174048,압구정올29000헤어,1,1,1,3
4696,s17910597,17910597,앙마헤어,1,1,1,3
4697,s1601862520,1601862520,글로리아,1,1,1,3
4698,s17900390,17900390,아씨머리방,1,1,1,3
4699,s1419151602,1419151602,지성헤어,1,1,1,3
4700,s20869389,20869389,준헤어아트,1,1,1,3
4701,s1896230093,1896230093,김석영헤어타운,1,1,1,3
4702,s1282893659,1282893659,수주머리나라,1,1,1,3
4703,s32359045,32359045,강헤어라인,1,1,1,3
4704,s1174239191,1174239191,정든헤어필,1,1,1,3
4705,s20876664,20876664,라렌느헤어,1,1,1,3
4706,s18789778,18789778,44번가미용실,1,1,1,3
4707,s1367831866,1367831866,샛별헤어아트,1,1,1,3
4708,s20830711,20830711,샛별미용실,1,1,1,3
4709,s1640715229,1640715229,샛별미용실,1,1,1,3
4710,s1391073594,1391073594,샛별미용실,1,1,1,3
4711,s20922442,20922442,모아모아미용실,1,1,1,3
4712,s17945855,17945855,효춘미용실,1,1,1,3
4713,s17904967,17904967,전지혜미용실,1,1,1,3
4714,s31090623,31090623,진미용실,1,1,1,3
4715,s18772667,18772667,영빈미용실,1,1,1,3
4716,s1486009865,1486009865,일대일헤어샵,1,1,1,3
4717,s1831103226,1831103226,머리사랑,1,1,1,3
4718,s1908699085,1908699085,러브솔헤어샵,1,1,1,3
4719,s1910481206,1910481206,이지헤어,1,1,1,3
4720,s20391099,20391099,방문자헤어아트,1,1,1,3
4721,s1193896229,1193896229,칼리헤어,1,1,1,3
4722,s20922687,20922687,멧뜰헤어샵,1,1,1,3
4723,s20884690,20884690,대경미용실,1,1,1,3
4724,s1896543768,1896543768,수정헤어샵,1,1,1,3
4725,s1501720293,1501720293,누리헤어,1,1,1,3
4726,s17895293,17895293,그라시아미용실,1,1,1,3
4727,s1805603808,1805603808,송정미용실,1,1,1,3
4728,s1695513603,1695513603,모안10헤어 송정점,1,1,1,3
4729,s1866548425,1866548425,아름헤어,1,1,1,3
4730,s20869299,20869299,엣지헤어,1,1,1,3
4731,s20888523,20888523,최미용실,1,1,1,3
4732,s18796698,18796698,헤어코코,1,1,1,3
4733,s1649894349,1649894349,Iris헤어,1,1,1,3
4734,s20899934,20899934,옥이미용실,1,1,1,3
4735,s1245776455,1245776455,지우헤어,1,1,1,3
4736,s20934542,20934542,은혜헤어,1,1,1,3
4737,s20852842,20852842,자연미인,1,1,1,3
4738,s18717523,18717523,헤어컷미용실,1,1,1,3
4739,s13558546,13558546,우리미용상사,1,1,1,3
4740,s18137812,18137812,진헤어클리닉,1,1,1,3
4741,s1593459405,1593459405,벧엘미용실,1,1,1,3
4742,s1030660869,1030660869,그냥미용실,1,1,1,3
4743,s1030957511,1030957511,슈와리헤어,1,1,1,3
4744,s1412815889,1412815889,꾸밈헤어,1,1,1,3
4745,s18137350,18137350,도원미용실,1,1,1,3
4746,s18137920,18137920,강미희헤어스튜디오,1,1,1,3
4747,s1579390871,1579390871,다헤어샵,1,1,1,3
4748,s18718183,18718183,영미용실,1,1,1,3
4749,s1778585660,1778585660,이송임헤어모드,1,1,1,3
4750,s1514786115,1514786115,민정헤어샵,1,1,1,3
4751,s20882205,20882205,원효미용실,1,1,1,3
4752,s910413062,910413062,hairshop 시선,1,1,1,3
4753,s496225729,496225729,결헤어,1,1,1,3
4754,s1245595845,1245595845,문헤어,1,1,1,3
4755,s20847465,20847465,깍세헤어클럽,1,1,1,3
4756,s1074833137,1074833137,양지헤어아트,1,1,1,3
4757,s18137804,18137804,형한나미용실,1,1,1,3
4758,s18137354,18137354,라옥화헤어앤,1,1,1,3
4759,s18139047,18139047,고운헤어,1,1,1,3
4760,s37927880,37927880,세인트엘가,1,1,1,3
4761,s1676161715,1676161715,Salon de J,1,1,1,3
4762,s1912325221,1912325221,서진헤어,1,1,1,3
4763,s1035050401,1035050401,김현헤어,1,1,1,3
4764,s1188330887,1188330887,박철헤어 블리스,1,1,1,3
4765,s1403241101,1403241101,예쁜머리,1,1,1,3
4766,s1783996688,1783996688,코코스미용실,1,1,1,3
4767,s1117419705,1117419705,나드리헤어샵,1,1,1,3
4768,s48867158,48867158,토마토헤어샵,1,1,1,3
4769,s20907276,20907276,우리미용실,1,1,1,3
4770,s1823111945,1823111945,김영헤어,1,1,1,3
4771,s1973990308,1973990308,누벨바그헤어살롱 숙대점,1,1,1,3
4772,s344809253,344809253,스크린헤어 숙대점,1,1,1,3
4773,s1464694261,1464694261,아비떼 헤어& 헤드 스파,1,1,1,3
4774,s1113650150,1113650150,초이헤어코코,1,1,1,3
4775,s1903203656,1903203656,넘버나인 헤어,1,1,1,3
4776,s38278869,38278869,헤어살롱엘,1,1,1,3
4777,s1970273748,1970273748,온헤어샵,1,1,1,3
4778,s18137806,18137806,헤어시스템,1,1,1,3
4779,s1570018911,1570018911,헤어비즈미용실,1,1,1,3
4780,s1997730890,1997730890,헤어비즈미용실,1,1,1,3
4781,s20943223,20943223,동양미용타운,1,1,1,3
4782,s20924453,20924453,헤어토탈진,1,1,1,3
4783,s1258459562,1258459562,정미용실,1,1,1,3
4784,s20555484,20555484,토모토모헤어,1,1,1,3
4785,s1840438960,1840438960,가나미용실,1,1,1,3
4786,s18170194,18170194,남정희미용실,1,1,1,3
4787,s20847628,20847628,제이미용실,1,1,1,3
4788,s18195110,18195110,윤희헤어콜렉션,1,1,1,3
4789,s1825422884,1825422884,정명숙헤어뷰티샵,1,1,1,3
4790,s1057450385,1057450385,이정헤어뱅크,1,1,1,3
4791,s1613754663,1613754663,박희복뷰티,1,1,1,3
4792,s20823932,20823932,꽃향기미용실,1,1,1,3
4793,s18146311,18146311,산호미용실,1,1,1,3
4794,s18177612,18177612,임지숙헤어센스,1,1,1,3
4795,s208377993,208377993,신데렐라헤어,1,1,1,3
4796,s1687893362,1687893362,샴푸향기,1,1,1,3
4797,s34352824,34352824,헤어나라,1,1,1,3
4798,s37349497,37349497,조윤정헤어몰,1,1,1,3
4799,s1244486462,1244486462,햇님머리,1,1,1,3
4800,s20882277,20882277,승리미용실,1,1,1,3
4801,s32244275,32244275,지혜미용실,1,1,1,3
4802,s1732841888,1732841888,MIN.D hair,1,1,1,3
4803,s1694514486,1694514486,선천미용실,1,1,1,3
4804,s11700929,11700929,행운미용실,1,1,1,3
4805,s18717001,18717001,머리세상,1,1,1,3
4806,s20859478,20859478,세바헤어,1,1,1,3
4807,s1511294916,1511294916,예술헤어샵,1,1,1,3
4808,s20828251,20828251,그린미용실,1,1,1,3
4809,s18124847,18124847,정미용실,1,1,1,3
4810,s1744728226,1744728226,미지헤어,1,1,1,3
4811,s1389175796,1389175796,바로그 헤어,1,1,1,3
4812,s20912675,20912675,황지미용실,1,1,1,3
4813,s1551238297,1551238297,블루컷,1,1,1,3
4814,s1130659453,1130659453,이편한헤어,1,1,1,3
4815,s1773070242,1773070242,헤어로,1,1,1,3
4816,s20847608,20847608,헤어센스미용실,1,1,1,3
4817,s20943165,20943165,토토미용실,1,1,1,3
4818,s746280707,746280707,현대미용실,1,1,1,3
4819,s18192646,18192646,진 헤어콜렉션,1,1,1,3
4820,s20882420,20882420,너도나미용실,1,1,1,3
4821,s18127385,18127385,박소연헤어포즈,1,1,1,3
4822,s1702290019,1702290019,미담헤어,1,1,1,3
4823,s18152790,18152790,디디헤어,1,1,1,3
4824,s20889686,20889686,진미용실,1,1,1,3
4825,s17967025,17967025,금별미용실,1,1,1,3
4826,s20890559,20890559,헤어프로포즈,1,1,1,3
4827,s1862872276,1862872276,남자의자격,1,1,1,3
4828,s66152662,66152662,산리쯔헤어 창신점,1,1,1,3
4829,s1341611850,1341611850,바나나헤어,1,1,1,3
4830,s1259317949,1259317949,헤어 20j,1,1,1,3
4831,s18599940,18599940,씨씨헤어클럽,1,1,1,3
4832,s1811275983,1811275983,유정미용실,1,1,1,3
4833,s20856202,20856202,문미용실,1,1,1,3
4834,s31234574,31234574,아우라K,1,1,1,3
4835,s18721604,18721604,민들레미용실,1,1,1,3
4836,s1760276476,1760276476,몽땅미용실,1,1,1,3
4837,s1676134141,1676134141,유니다,1,1,1,3
4838,s250018126,250018126,리안헤어 신풍점,1,1,1,3
4839,s20936553,20936553,승희미용실,1,1,1,3
4840,s1087976667,1087976667,오월헤어,1,1,1,3
4841,s1958056989,1958056989,헤어아르떼,1,1,1,3
4842,s13411734,13411734,채유림헤어,1,1,1,3
4843,s1100127391,1100127391,로즈마리헤어,1,1,1,3
4844,s12047326,12047326,띠아모헤어,1,1,1,3
4845,s17979722,17979722,해피미용실,1,1,1,3
4846,s1823010840,1823010840,써니헤어,1,1,1,3
4847,s1117931782,1117931782,살롱드비 문래점,1,1,1,3
4848,s20634579,20634579,제이헤어샵,1,1,1,3
4849,s17919197,17919197,상희헤어샵,1,1,1,3
4850,s17979729,17979729,성화미용실,1,1,1,3
4851,s1009905052,1009905052,바른헤어,1,1,1,3
4852,s1442676024,1442676024,끌림미용실,1,1,1,3
4853,s1101456430,1101456430,박미용실,1,1,1,3
4854,s18671556,18671556,머리하기좋은날,1,1,1,3
4855,s1725610155,1725610155,사랑방미용실,1,1,1,3
4856,s1243893252,1243893252,선헤어샵,1,1,1,3
4857,s20845400,20845400,뷰티메이커스헤어살롱 신도림점,1,1,1,3
4858,s1672175188,1672175188,민혜영미용실,1,1,1,3
4859,s17979714,17979714,지영헤어,1,1,1,3
4860,s1545869385,1545869385,순헤어,1,1,1,3
4861,s1967259335,1967259335,루비헤어,1,1,1,3
4862,s20913594,20913594,사랑헤어샵,1,1,1,3
4863,s20735574,20735574,보라헤어,1,1,1,3
4864,s20902227,20902227,명연숙미용실,1,1,1,3
4865,s1026507111,1026507111,송헤어,1,1,1,3
4866,s18714735,18714735,헤어준미용실,1,1,1,3
4867,s18733876,18733876,경아미용실,1,1,1,3
4868,s18195097,18195097,조은미용실,1,1,1,3
4869,s20935411,20935411,로뎀미용실,1,1,1,3
4870,s18734292,18734292,준오헤어,1,1,1,3
4871,s20866700,20866700,이화뷰티팜,1,1,1,3
4872,s18185071,18185071,민들레미용실,1,1,1,3
4873,s1152025436,1152025436,고은헤어샵,1,1,1,3
4874,s98270217,98270217,제이헤어,1,1,1,3
4875,s1926702071,1926702071,예쁨헤어,1,1,1,3
4876,s18730966,18730966,신윤재헤어샵,1,1,1,3
4877,s1905548861,1905548861,배배헤어,1,1,1,3
4878,s20916756,20916756,나리미용실,1,1,1,3
4879,s20912502,20912502,머리나라,1,1,1,3
4880,s18734289,18734289,수미용실,1,1,1,3
4881,s1903006184,1903006184,다솜헤어,1,1,1,3
4882,s20916581,20916581,상록수미용실,1,1,1,3
4883,s1862959386,1862959386,비너스헤어라인,1,1,1,3
4884,s1289631260,1289631260,글라라 미용실,1,1,1,3
4885,s1339861493,1339861493,류가네미용실,1,1,1,3
4886,s1126781615,1126781615,순영미용실,1,1,1,3
4887,s1780566256,1780566256,주쌀롱,1,1,1,3
4888,s1101112530,1101112530,은혜미용타운,1,1,1,3
4889,s20927694,20927694,태양미용실,1,1,1,3
4890,s1349584173,1349584173,주향기헤어샵,1,1,1,3
4891,s20939217,20939217,성궁미용실,1,1,1,3
4892,s1044395714,1044395714,뷰티보,1,1,1,3
4893,s1768395485,1768395485,김민자헤어월드,1,1,1,3
4894,s18124853,18124853,선미용실,1,1,1,3
4895,s13151491,13151491,승미용실,1,1,1,3
4896,s1488633777,1488633777,도우미미용실,1,1,1,3
4897,s1102176591,1102176591,김쌤빠마,1,1,1,3
4898,s32176837,32176837,머리사랑,1,1,1,3
4899,s20922636,20922636,정미용실,1,1,1,3
4900,s1746370153,1746370153,J2헤어,1,1,1,3
4901,s11676362,11676362,장윤경헤어,1,1,1,3
4902,s35372400,35372400,알레이 용산점,1,1,1,3
4903,s1025438386,1025438386,소피아 헤어,1,1,1,3
4904,s20942956,20942956,명동미용실,1,1,1,3
4905,s1310346818,1310346818,계림미용실,1,1,1,3
4906,s1251977335,1251977335,다이아나헤어샾,1,1,1,3
4907,s1387715600,1387715600,OL SALON,1,1,1,3
4908,s37699655,37699655,E헤어,1,1,1,3
4909,s18195117,18195117,이유진미용실,1,1,1,3
4910,s1988773107,1988773107,스타일맨 헤어,1,1,1,3
4911,s1308185677,1308185677,송채원헤어,1,1,1,3
4912,s1723600255,1723600255,수헤어,1,1,1,3
4913,s1890990404,1890990404,모아헤어엔네일,1,1,1,3
4914,s20903471,20903471,이얀헤어갤러리,1,1,1,3
4915,s1592733364,1592733364,문배동미장원,1,1,1,3
4916,sk37256493,k37256493,오드리헤어,1,1,1,3
4917,s1466439005,1466439005,라인미용실,1,1,1,3
4918,s1895388744,1895388744,역촌동 하늬헤어,1,1,1,3
4919,s37185721,37185721,ACME HAIR,1,1,1,3
4920,s37344846,37344846,모던헤어,1,1,1,3
4921,s36827271,36827271,참헤어살롱,1,1,1,3
4922,s18683343,18683343,민정헤어,1,1,1,3
4923,s37538000,37538000,55번가 헤어샵,1,1,1,3
4924,s1714882080,1714882080,신데렐라헤어,1,1,1,3
4925,s20862924,20862924,혜진헤어샵,1,1,1,3
4926,s1207990314,1207990314,순백헤어,1,1,1,3
4927,s1024021411,1024021411,압구정헤어,1,1,1,3
4928,s1908005580,1908005580,마샹스헤어,1,1,1,3
4929,s1836561790,1836561790,힐링헤어,1,1,1,3
4930,s1507029992,1507029992,아이유미용실,1,1,1,3
4931,s1845385455,1845385455,머리해라,1,1,1,3
4932,s1877812484,1877812484,예쁘다미용실,1,1,1,3
4933,s20897529,20897529,본색헤어,1,1,1,3
4934,s18174475,18174475,달리헤어샵,1,1,1,3
4935,s18170453,18170453,라프랑스미용실,1,1,1,3
4936,s1257578879,1257578879,송윤주헤어,1,1,1,3
4937,s20824042,20824042,동네헤어,1,1,1,3
4938,s915311073,915311073,허경헤어샾,1,1,1,3
4939,s1240915202,1240915202,헤어팝,1,1,1,3
4940,s1297799827,1297799827,기억헤어,1,1,1,3
4941,s21086210,21086210,헤어르보우,1,1,1,3
4942,s1274447887,1274447887,머리하는날,1,1,1,3
4943,s356722586,356722586,란헤어샵,1,1,1,3
4944,s1367542313,1367542313,힐헤어,1,1,1,3
4945,s634575841,634575841,헤어시즌,1,1,1,3
4946,s35629440,35629440,루다헤어,1,1,1,3
4947,s34994543,34994543,머리하는날,1,1,1,3
4948,s37811375,37811375,윤헤어갤러리,1,1,1,3
4949,s35135093,35135093,다빈헤어비스,1,1,1,3
4950,s35252026,35252026,서무니헤어,1,1,1,3
4951,s1486180131,1486180131,나라헤어샵,1,1,1,3
4952,s1250981294,1250981294,엣지포미,1,1,1,3
4953,s1676090797,1676090797,맨투맨,1,1,1,3
4954,s1418210648,1418210648,다온헤어,1,1,1,3
4955,s18078191,18078191,김은정미용실,1,1,1,3
4956,s18673011,18673011,자르지오,1,1,1,3
4957,s18185094,18185094,세련미용실,1,1,1,3
4958,s1291622433,1291622433,길살롱,1,1,1,3
4959,s1030567031,1030567031,에이플러스헤어,1,1,1,3
4960,s1082381438,1082381438,컬러드바이,1,1,1,3
4961,s37186287,37186287,조소영헤어센세이션,1,1,1,3
4962,s1757324341,1757324341,헤어센세이션,1,1,1,3
4963,s1886782222,1886782222,비바벨,1,1,1,3
4964,s20922222,20922222,머리치장,1,1,1,3
4965,s1451285198,1451285198,럭스헤어,1,1,1,3
4966,s1033295355,1033295355,스칼렛 헤어살롱,1,1,1,3
4967,s1737000162,1737000162,티는아이미용실,1,1,1,3
4968,s20868900,20868900,수정미용실,1,1,1,3
4969,s18677134,18677134,유한미용실,1,1,1,3
4970,s1466479496,1466479496,이현헤어아트,1,1,1,3
4971,s20861349,20861349,정미용실,1,1,1,3
4972,s1781948596,1781948596,상상헤어,1,1,1,3
4973,s1724867503,1724867503,일구헤어,1,1,1,3
4974,s1087931129,1087931129,다해헤어,1,1,1,3
4975,s35103103,35103103,류시자BeautyonHair,1,1,1,3
4976,s1738013850,1738013850,은현헤어,1,1,1,3
4977,s1470018825,1470018825,코코헤어샵,1,1,1,3
4978,s31135256,31135256,vivi헤어,1,1,1,3
4979,s1967326357,1967326357,이든헤어,1,1,1,3
4980,s1567477214,1567477214,미작헤어,1,1,1,3
4981,s1799134665,1799134665,헤어뷰,1,1,1,3
4982,s18169965,18169965,배정머리방,1,1,1,3
4983,s1431590164,1431590164,그레이스헤어,1,1,1,3
4984,s1844540938,1844540938,윤헤어,1,1,1,3
4985,s1837656365,1837656365,Nue,1,1,1,3
4986,s1641441104,1641441104,엠와이청담,1,1,1,3
4987,s1376479605,1376479605,어반그라운드헤어 이촌역점,1,1,1,3
4988,s1128976066,1128976066,제이썸 헤어살롱,1,1,1,3
4989,s1761140190,1761140190,머리야헤어,1,1,1,3
4990,s1498727891,1498727891,봄헤어,1,1,1,3
4991,s1990772197,1990772197,홍샵,1,1,1,3
4992,s1305144634,1305144634,우리헤어,1,1,1,3
4993,s19407125,19407125,미용실엘리,1,1,1,3
4994,s1291289157,1291289157,아셀헤어,1,1,1,3
4995,s19588968,19588968,티엠스토리,1,1,1,3
4996,s1306435377,1306435377,올리브헤어,1,1,1,3
4997,s13327501,13327501,미하루,1,1,1,3
4998,s19334508,19334508,은조미용실,1,1,1,3
4999,s31801495,31801495,메리린헤어스튜디오,1,1,1,3
5000,s35142122,35142122,조기행헤어,1,1,1,3
5001,s1883431777,1883431777,미사랑,1,1,1,3
5002,s20920218,20920218,옥천미용실,1,1,1,3
5003,s1400610180,1400610180,헤어갤러리,1,1,1,3
5004,s1862052744,1862052744,리헤어칼라,1,1,1,3
5005,s20893691,20893691,헤어센스,1,1,1,3
5006,s33692039,33692039,성희비비헤어샵,1,1,1,3
5007,s1714599179,1714599179,이지연머리방,1,1,1,3
5008,s20859241,20859241,에디헤어,1,1,1,3
5009,s18139138,18139138,은조미용실,1,1,1,3
5010,s20889988,20889988,씨씨헤어샵,1,1,1,3
5011,s11730322,11730322,블루클럽 한남동점,1,1,1,3
5012,s1112436916,1112436916,뷰티헤어센스,1,1,1,3
5013,s12024691,12024691,프리마헤어,1,1,1,3
5014,s1196389620,1196389620,아리사미용실,1,1,1,3
5015,s18726043,18726043,김유경미용실,1,1,1,3
5016,s20908756,20908756,라임헤어라이프,1,1,1,3
5017,s81970484,81970484,애슐리헤어,1,1,1,3
5018,s13550698,13550698,Jays Hairdressing,1,1,1,3
5019,s1806950811,1806950811,블리스풀 바버샵,1,1,1,3
5020,s1472778906,1472778906,모브살롱,1,1,1,3
5021,s1101447921,1101447921,특별한 감성,1,1,1,3
5022,s20897438,20897438,조림미용실,1,1,1,3
5023,s56172564,56172564,jooshop hair,1,1,1,3
5024,s756952057,756952057,예작헤어,1,1,1,3
5025,s20939530,20939530,180도헤어,1,1,1,3
5026,s20822387,20822387,유헤어라인,1,1,1,3
5027,s1096717126,1096717126,주주헤어클럽,1,1,1,3
5028,s1580968366,1580968366,컷트잘하는미용실,1,1,1,3
5029,s11834705,11834705,패밀리헤어샵,1,1,1,3
5030,s20931890,20931890,수정헤어샵,1,1,1,3
5031,s20458373,20458373,안혜경미용실,1,1,1,3
5032,s18193434,18193434,현아미용실,1,1,1,3
5033,s31549555,31549555,헤어포유 이태원점,1,1,1,3
5034,s38328106,38328106,우미해s헤어샵,1,1,1,3
5035,s1807723648,1807723648,헤어센스,1,1,1,3
5036,s20927748,20927748,인헤어클럽,1,1,1,3
5037,s1512538181,1512538181,SM 헤어,1,1,1,3
5038,s20931509,20931509,컷트클럽,1,1,1,3
5039,s11730320,11730320,블루클럽 용산점,1,1,1,3
5040,s37765370,37765370,준헤어샵,1,1,1,3
5041,s20874676,20874676,진헤어샵,1,1,1,3
5042,s13451853,13451853,보그01헤어,1,1,1,3
5043,s18714437,18714437,더끌림,1,1,1,3
5044,s1879093217,1879093217,헤어엘리,1,1,1,3
5045,s1752636389,1752636389,큐티풀헤어,1,1,1,3
5046,s1584889599,1584889599,낭띠헤어,1,1,1,3
5047,s20916432,20916432,SW머리방,1,1,1,3
5048,s1048682701,1048682701,컷트클럽,1,1,1,3
5049,s11730291,11730291,블루클럽 남영동점,1,1,1,3
5050,s19417736,19417736,샬롬미용실,1,1,1,3
5051,s1911171432,1911171432,임마누엘 뷰티살롱,1,1,1,3
5052,s18149380,18149380,이광용헤어,1,1,1,3
5053,s18733766,18733766,깍끌레헤어샵,1,1,1,3
5054,s20878356,20878356,주노헤어샵,1,1,1,3
5055,s33510804,33510804,로즈헤어,1,1,1,3
5056,s20924050,20924050,밈미용실,1,1,1,3
5057,s20943197,20943197,헤어까미,1,1,1,3
5058,s20870469,20870469,미니미용실,1,1,1,3
5059,s1911329799,1911329799,케이의미장원,1,1,1,3
5060,s1771897277,1771897277,정우헤어,1,1,1,3
5061,s18127254,18127254,예민헤어아트,1,1,1,3
5062,s1629641492,1629641492,믿음헤어라인,1,1,1,3
5063,s1712440429,1712440429,믿음헤어라인,1,1,1,3
5064,s34458465,34458465,빌라지오헤어,1,1,1,3
5065,s20920462,20920462,이지헤어,1,1,1,3
5066,s1029078291,1029078291,미희헤어샵,1,1,1,3
5067,s1066808816,1066808816,상록수헤어샵,1,1,1,3
5068,s20893813,20893813,석은숙헤어아트,1,1,1,3
5069,s34540453,34540453,은지노헤어,1,1,1,3
5070,s18734172,18734172,안혜경헤어쉬멩,1,1,1,3
5071,s1037283975,1037283975,하루스타일,1,1,1,3
5072,s1004387540,1004387540,토리헤어 은평뉴타운점,1,1,1,3
5073,s37895225,37895225,스타일리스트,1,1,1,3
5074,s60342763,60342763,더스타일헤어,1,1,1,3
5075,s38705073,38705073,살롱후바,1,1,1,3
5076,s18714321,18714321,세븐헤어샵,1,1,1,3
5077,s20901597,20901597,바버샵&헤어살롱,1,1,1,3
5078,s37822826,37822826,너희가찾던미용실,1,1,1,3
5079,s38304972,38304972,jp hair,1,1,1,3
5080,s11694583,11694583,리 헤어아트,1,1,1,3
5081,s1990036314,1990036314,귀빈미용실,1,1,1,3
5082,s17925156,17925156,우성미용실,1,1,1,3
5083,s17967204,17967204,현대미용실,1,1,1,3
5084,s20871253,20871253,이영원헤어,1,1,1,3
5085,s20643267,20643267,붐헤어,1,1,1,3
5086,s1717650956,1717650956,다인헤어,1,1,1,3
5087,s1999987439,1999987439,퍼블릭헤어,1,1,1,3
5088,s20355142,20355142,기분좋은날,1,1,1,3
5089,s1766126183,1766126183,륜경헤어,1,1,1,3
5090,s19017416,19017416,정헤어스케치,1,1,1,3
5091,s1290768736,1290768736,해와달미용실,1,1,1,3
5092,s19011677,19011677,행운헤어,1,1,1,3
5093,s20851791,20851791,민지헤어샵,1,1,1,3
5094,s20840132,20840132,진화미용실,1,1,1,3
5095,s20886806,20886806,이승은헤어,1,1,1,3
5096,s1527613414,1527613414,모두다헤어살롱 대방점,1,1,1,3
5097,s20939789,20939789,미다듬미용실,1,1,1,3
5098,s20633821,20633821,컷트맨보라매역점,1,1,1,3
5099,s1914227658,1914227658,미소헤어,1,1,1,3
5100,s20851895,20851895,크로바미용실,1,1,1,3
5101,s20625106,20625106,온누리헤어숍,1,1,1,3
5102,s1748691947,1748691947,오땡큐 대림동점,1,1,1,3
5103,s20905610,20905610,헤어짱,1,1,1,3
5104,s20840175,20840175,뽀끌래짜를래,1,1,1,3
5105,s19419166,19419166,수경미용실,1,1,1,3
5106,s20638243,20638243,드림헤어플러스,1,1,1,3
5107,s20863278,20863278,유성미용실,1,1,1,3
5108,s20828673,20828673,헤어스테이지,1,1,1,3
5109,s20832521,20832521,희미용실,1,1,1,3
5110,s18604264,18604264,박신자미용실,1,1,1,3
5111,s19012052,19012052,오페라미용실,1,1,1,3
5112,s20628167,20628167,하나미용실,1,1,1,3
5113,s19012310,19012310,하나헤어,1,1,1,3
5114,s20890357,20890357,파랑새미용실,1,1,1,3
5115,s18684483,18684483,늘봄미용실,1,1,1,3
5116,s1693528319,1693528319,헤어클릭,1,1,1,3
5117,s1066370820,1066370820,늘봄헤어,1,1,1,3
5118,s37122965,37122965,늘봄헤어,1,1,1,3
5119,s19013925,19013925,나비헤어,1,1,1,3
5120,s18564069,18564069,이철웅헤어커커,1,1,1,3
5121,s1825244294,1825244294,리오헤어,1,1,1,3
5122,s1252261943,1252261943,신데렐라헤어샵,1,1,1,3
5123,s1981477993,1981477993,성원헤어모드,1,1,1,3
5124,s20844216,20844216,허브헤어샵 보라매점,1,1,1,3
5125,s20939871,20939871,머리사랑,1,1,1,3
5126,s11730239,11730239,블루클럽 문래점,1,1,1,3
5127,s1496865044,1496865044,은헤어클럽,1,1,1,3
5128,s19002250,19002250,박영수헤어,1,1,1,3
5129,s18995334,18995334,이은주헤어갤러리,1,1,1,3
5130,s20920837,20920837,우리미용실,1,1,1,3
5131,s1057012126,1057012126,윤규리헤어,1,1,1,3
5132,s1693520639,1693520639,이금숙헤어,1,1,1,3
5133,s1197017634,1197017634,미고헤어,1,1,1,3
5134,s32110563,32110563,신미옥헤어뷰티끄,1,1,1,3
5135,s31042982,31042982,파알헤어,1,1,1,3
5136,s1967390642,1967390642,석희미용실,1,1,1,3
5137,s13159663,13159663,더헤어,1,1,1,3
5138,s34155635,34155635,헤어미가,1,1,1,3
5139,s20627424,20627424,미헤어리더,1,1,1,3
5140,s207006956,207006956,M by Marie,1,1,1,3
5141,s1489042912,1489042912,리원헤어,1,1,1,3
5142,s13455005,13455005,달려라 레게,1,1,1,3
5143,s11730250,11730250,블루클럽 서여의도점,1,1,1,3
5144,s20909464,20909464,백운미용실,1,1,1,3
5145,s1061085606,1061085606,헤어포유,1,1,1,3
5146,s20909485,20909485,헤어랑미용실,1,1,1,3
5147,s1045883174,1045883174,헤어코디,1,1,1,3
5148,s1347458605,1347458605,팝콘헤어,1,1,1,3
5149,s18583330,18583330,샬롱드마샬 여의도점,1,1,1,3
5150,s837383931,837383931,머리하는풍경,1,1,1,3
5151,s20824605,20824605,이신영헤어,1,1,1,3
5152,s20882916,20882916,한아름헤어,1,1,1,3
5153,s20632913,20632913,신데렐라,1,1,1,3
5154,s1383350688,1383350688,크라크라,1,1,1,3
5155,s20621853,20621853,커트클럽,1,1,1,3
5156,s1813924868,1813924868,비녀미용실,1,1,1,3
5157,s1885928134,1885928134,송지헤어,1,1,1,3
5158,s36803115,36803115,레드헤어,1,1,1,3
5159,s79600320,79600320,윤진the헤어,1,1,1,3
5160,s1705688465,1705688465,퀸보떼비단,1,1,1,3
5161,s1269498171,1269498171,정회권헤어샵맨,1,1,1,3
5162,s1751879101,1751879101,라파헤어,1,1,1,3
5163,s19003896,19003896,헤어아트,1,1,1,3
5164,s20634469,20634469,예쁜머리헤어샵,1,1,1,3
5165,s1004641413,1004641413,헤어보이,1,1,1,3
5166,s1823592942,1823592942,젬마헤어,1,1,1,3
5167,s19002529,19002529,이연헤어디오,1,1,1,3
5168,s37486805,37486805,써니헤어,1,1,1,3
5169,s1218242568,1218242568,김호증모가발 임정숙머리나라,1,1,1,3
5170,s1606156198,1606156198,수헤어,1,1,1,3
5171,s11369418,11369418,H STYLE헤어살롱 대림점,1,1,1,3
5172,s34581289,34581289,휴헤어,1,1,1,3
5173,s19497505,19497505,블루클럽 당산역점,1,1,1,3
5174,s1500559761,1500559761,신세계미용실,1,1,1,3
5175,s36170440,36170440,준헤어디자인,1,1,1,3
5176,s393892567,393892567,힐링헤어,1,1,1,3
5177,s20636929,20636929,윤헤어샵,1,1,1,3
5178,s20641490,20641490,코디헤어,1,1,1,3
5179,s20630672,20630672,쎄븐헤어아트,1,1,1,3
5180,s19008691,19008691,수헤어아트,1,1,1,3
5181,s1941281937,1941281937,비밍Hair by YUJIN,1,1,1,3
5182,s18596397,18596397,이재순헤어시티,1,1,1,3
5183,s10984038,10984038,참 미용실,1,1,1,3
5184,s20898043,20898043,두영헤어샵,1,1,1,3
5185,s20936042,20936042,심민아머리박사,1,1,1,3
5186,s1950290304,1950290304,진헤어,1,1,1,3
5187,s19407730,19407730,블루클럽 낙원점,1,1,1,3
5188,s13027050,13027050,헤어스케치,1,1,1,3
5189,sk17963614,k17963614,화원미용실,1,1,1,3
5190,s1899096578,1899096578,삼성미용실,1,1,1,3
5191,s20643260,20643260,제일헤어샵,1,1,1,3
5192,s20928357,20928357,신화미용실,1,1,1,3
5193,s20901727,20901727,킴머리방,1,1,1,3
5194,s1438526711,1438526711,라미라헤어클럽,1,1,1,3
5195,s34604443,34604443,세원미장,1,1,1,3
5196,s20909541,20909541,헤어아트,1,1,1,3
5197,s1142300219,1142300219,머리향기,1,1,1,3
5198,s1368631474,1368631474,한해은헤어라인,1,1,1,3
5199,s20935966,20935966,마샬헤어케어,1,1,1,3
5200,s31401671,31401671,지영미용실,1,1,1,3
5201,s20932449,20932449,한나미용타운,1,1,1,3
5202,s1934456831,1934456831,머리치장미용실,1,1,1,3
5203,s20878828,20878828,영미미용실,1,1,1,3
5204,s1322506614,1322506614,고수머리방,1,1,1,3
5205,s1128856785,1128856785,청탑미용실,1,1,1,3
5206,s1353981347,1353981347,헤어스토리,1,1,1,3
5207,s19018994,19018994,이태리헤어,1,1,1,3
5208,s20871079,20871079,단골머리방,1,1,1,3
5209,s1525559850,1525559850,공원헤어샵,1,1,1,3
5210,s1110542776,1110542776,헤어살롱김은,1,1,1,3
5211,s37445695,37445695,남자이야기,1,1,1,3
5212,s30858641,30858641,더헤어샵,1,1,1,3
5213,s1176516242,1176516242,박남준미용실,1,1,1,3
5214,s1920256093,1920256093,머리나라,1,1,1,3
5215,s38491396,38491396,이가자헤어비스 영등포롯데점,1,1,1,3
5216,s1684825025,1684825025,이가자헤어비스 롯데백화점영등포점,1,1,1,3
5217,s18547933,18547933,머리하는풍경,1,1,1,3
5218,s20624092,20624092,현대헤어리더,1,1,1,3
5219,s20820571,20820571,김규리미용실,1,1,1,3
5220,s20916985,20916985,모아미용실,1,1,1,3
5221,s20832612,20832612,헤어톡,1,1,1,3
5222,s20928353,20928353,머리애,1,1,1,3
5223,s1039224257,1039224257,리헤어,1,1,1,3
5224,s13160823,13160823,가토헤어,1,1,1,3
5225,s20936024,20936024,까망헤어클럽,1,1,1,3
5226,s1604657273,1604657273,성미용실,1,1,1,3
5227,s37206858,37206858,예가헤어샵,1,1,1,3
5228,s20886470,20886470,김수경헤어,1,1,1,3
5229,s20624049,20624049,남미헤어,1,1,1,3
5230,s1123994707,1123994707,올리브헤어,1,1,1,3
5231,s20633704,20633704,금잔디미용실,1,1,1,3
5232,s20874986,20874986,가위손,1,1,1,3
5233,s19019168,19019168,김자영헤어샵,1,1,1,3
5234,s20226776,20226776,시온미용실,1,1,1,3
5235,s1518882752,1518882752,현미용실,1,1,1,3
5236,s1473634615,1473634615,현미용실,1,1,1,3
5237,s20886643,20886643,예인헤어,1,1,1,3
5238,s1086319846,1086319846,신도뷰티샵,1,1,1,3
5239,s1386767983,1386767983,주리헤어,1,1,1,3
5240,s20844160,20844160,김성자헤어라인,1,1,1,3
5241,s1145069759,1145069759,수경헤어라인,1,1,1,3
5242,s18644693,18644693,금성이용,1,1,1,3
5243,s1297550180,1297550180,서찬헤어,1,1,1,3
5244,s20871202,20871202,가위와빗,1,1,1,3
5245,s11700426,11700426,정현선헤어살롱,1,1,1,3
5246,s1340947359,1340947359,금가위머리사랑,1,1,1,3
5247,s1147317615,1147317615,진헤어스케치,1,1,1,3
5248,s1491119501,1491119501,리언헤어가,1,1,1,3
5249,s18689632,18689632,비단결,1,1,1,3
5250,s32112167,32112167,좋은만남,1,1,1,3
5251,s19406670,19406670,대원미용실,1,1,1,3
5252,s20913066,20913066,현대헤어라인,1,1,1,3
5253,s37867942,37867942,미시헤어필,1,1,1,3
5254,s20339477,20339477,필리아헤어살롱,1,1,1,3
5255,s20638463,20638463,헤어써플라이,1,1,1,3
5256,s1991798928,1991798928,머리못하는집,1,1,1,3
5257,s38491888,38491888,헤어베리,1,1,1,3
5258,s17999556,17999556,제리안헤어,1,1,1,3
5259,s17976051,17976051,티아라헤어,1,1,1,3
5260,s20852475,20852475,조미영머리만들기효자점,1,1,1,3
5261,s17999646,17999646,미래미용실,1,1,1,3
5262,s1034537343,1034537343,깍세미용실,1,1,1,3
5263,s38238312,38238312,M2HAIR,1,1,1,3
5264,s1561692025,1561692025,헤어스타일,1,1,1,3
5265,s1681003737,1681003737,서연헤어,1,1,1,3
5266,s72582488,72582488,헤어스토리,1,1,1,3
5267,s20844351,20844351,모궁,1,1,1,3
5268,s1922449552,1922449552,뷰티헤어,1,1,1,3
5269,s34458834,34458834,시마미용실,1,1,1,3
5270,s1930545666,1930545666,두발자유,1,1,1,3
5271,s1637184380,1637184380,제이헤어필,1,1,1,3
5272,s1120145199,1120145199,다인헤어샵,1,1,1,3
5273,s1219195407,1219195407,CC헤어클럽,1,1,1,3
5274,s20909666,20909666,두리원미용실,1,1,1,3
5275,s1743246660,1743246660,다인헤어샵,1,1,1,3
5276,s37868421,37868421,아모르헤어,1,1,1,3
5277,s37910700,37910700,헤어플레르,1,1,1,3
5278,s1943000901,1943000901,헤어스케치,1,1,1,3
5279,s1278978133,1278978133,남성컷트클럽 영등포점,1,1,1,3
5280,s20875380,20875380,카라헤어클럽,1,1,1,3
5281,s1631570156,1631570156,헤어스케치,1,1,1,3
5282,s20894583,20894583,머리하는날,1,1,1,3
5283,s37642711,37642711,Hair by 이오,1,1,1,3
5284,s20079631,20079631,가인헤어갤러리,1,1,1,3
5285,s1572865866,1572865866,한승화헤어,1,1,1,3
5286,s1717080847,1717080847,오렌지헤어샾&헤어마트,1,1,1,3
5287,s37468902,37468902,헤어르포엠,1,1,1,3
5288,s37208877,37208877,이든헤어,1,1,1,3
5289,sk17999305,k17999305,사랑미용실,1,1,1,3
5290,s1321068790,1321068790,남성컷트전문점,1,1,1,3
5291,s37746397,37746397,도로시 헤어,1,1,1,3
5292,s17951296,17951296,은미용실,1,1,1,3
5293,s34883105,34883105,김희주헤어닥터,1,1,1,3
5294,s20840328,20840328,주리헤어,1,1,1,3
5295,s20894756,20894756,조성구헤어드림,1,1,1,3
5296,s19535980,19535980,블루클럽 영등포역점,1,1,1,3
5297,s20921375,20921375,박현순헤어샵,1,1,1,3
5298,s20894386,20894386,소망헤어라인,1,1,1,3
5299,s19005100,19005100,김임순머리방,1,1,1,3
5300,s1818477751,1818477751,두다헤어,1,1,1,3
5301,s20902399,20902399,미모미용실,1,1,1,3
5302,s31390889,31390889,별헤어,1,1,1,3
5303,s1456858363,1456858363,살롱드플마,1,1,1,3
5304,s36105273,36105273,제이팜헤어,1,1,1,3
5305,s1119686906,1119686906,JJ헤어,1,1,1,3
5306,s20856134,20856134,선화헤어센스,1,1,1,3
5307,s20871633,20871633,정현미용실,1,1,1,3
5308,sk17997233,k17997233,세검미용실,1,1,1,3
5309,s18684069,18684069,궁전미용실,1,1,1,3
5310,s1057795312,1057795312,블랙핑크,1,1,1,3
5311,s20856305,20856305,하니미용실,1,1,1,3
5312,s20932561,20932561,러스헤어,1,1,1,3
5313,s1018088482,1018088482,허준 미용실,1,1,1,3
5314,s1054039444,1054039444,러스미용실,1,1,1,3
5315,s20928782,20928782,이영헤어펀,1,1,1,3
5316,s1805089744,1805089744,SSUM 헤어,1,1,1,3
5317,s1972151163,1972151163,낭자김미용실,1,1,1,3
5318,s20906229,20906229,정헤어샵,1,1,1,3
5319,s1139602367,1139602367,이쁜헤어,1,1,1,3
5320,s17931849,17931849,새라미용실,1,1,1,3
5321,s18660328,18660328,정부자미용실,1,1,1,3
5322,s1778241331,1778241331,꼼지헤어,1,1,1,3
5323,s20875200,20875200,진머리방,1,1,1,3
5324,s20886834,20886834,CAT헤어아트,1,1,1,3
5325,s20879063,20879063,혜인미용실,1,1,1,3
5326,s1232831144,1232831144,조아미용실,1,1,1,3
5327,s1953239088,1953239088,헤어살롱에비뉴엘,1,1,1,3
5328,s33342748,33342748,구피샵 신길점,1,1,1,3
5329,s1494322587,1494322587,수헤어,1,1,1,3
5330,s1341625538,1341625538,진헤어랜드,1,1,1,3
5331,s20898485,20898485,김민주헤어메세지,1,1,1,3
5332,s1530312191,1530312191,수지헤어,1,1,1,3
5333,s1198821632,1198821632,감성헤어살롱,1,1,1,3
5334,s17992946,17992946,헤어갤러리꽃담,1,1,1,3
5335,s151452057,151452057,스토리헤어,1,1,1,3
5336,s1009968212,1009968212,위즈헤어,1,1,1,3
5337,s17915840,17915840,영화미용실,1,1,1,3
5338,s18660463,18660463,지호헤어,1,1,1,3
5339,s1080713541,1080713541,M 헤어스토리,1,1,1,3
5340,s1571806342,1571806342,깍아볶아미용실,1,1,1,3
5341,s37397806,37397806,시민미용실,1,1,1,3
5342,s1744167103,1744167103,박민헤어아티스트,1,1,1,3
5343,s1184705709,1184705709,W스타일헤어By김미영,1,1,1,3
5344,s30887132,30887132,뷰티바이휘,1,1,1,3
5345,s20905181,20905181,오미헤어샵,1,1,1,3
5346,s1815039510,1815039510,헤어풍경,1,1,1,3
5347,s20627420,20627420,미장금헤어까페,1,1,1,3
5348,s1414911340,1414911340,쎄븐미용실,1,1,1,3
5349,s19408442,19408442,로얄헤어샵,1,1,1,3
5350,s32238214,32238214,파랑머리,1,1,1,3
5351,s30824055,30824055,지앤헤어모드,1,1,1,3
5352,s1147180284,1147180284,다영헤어샵,1,1,1,3
5353,s1584627542,1584627542,이레미용실,1,1,1,3
5354,s1730539414,1730539414,샤론미용실,1,1,1,3
5355,s20867834,20867834,블루꽃남동묘역점,1,1,1,3
5356,s20860109,20860109,유진머리방,1,1,1,3
5357,s1029689321,1029689321,헬로우컷 여의도점,1,1,1,3
5358,s20909931,20909931,윤정헤어폼,1,1,1,3
5359,s1868309635,1868309635,I미르헤어,1,1,1,3
5360,s31855402,31855402,헤어바이아톰,1,1,1,3
5361,s19018141,19018141,차은희헤어갤러리,1,1,1,3
5362,s20863418,20863418,헤어톡톡,1,1,1,3
5363,s37642384,37642384,꾸아퍼스트 동대문현대점,1,1,1,3
5364,s32505254,32505254,토니앤가이콘래드,1,1,1,3
5365,s37727240,37727240,노블헤어,1,1,1,3
5366,s20886562,20886562,이태리헤어도림점,1,1,1,3
5367,s36535714,36535714,이화헤어,1,1,1,3
5368,s1645020111,1645020111,혜민헤어스튜디오,1,1,1,3
5369,s21783406,21783406,라벨르헤어,1,1,1,3
5370,s20585699,20585699,컷팅 엣지,1,1,1,3
5371,s1596070137,1596070137,더뉴아이헤어,1,1,1,3
5372,s20824606,20824606,쁘띠헤어,1,1,1,3
5373,s20848021,20848021,드보라미용실,1,1,1,3
5374,s20920824,20920824,컷트클럽 신풍시장점,1,1,1,3
5375,s20637668,20637668,헤어매직,1,1,1,3
5376,s1801094206,1801094206,Yoons Hair,1,1,1,3
5377,s1540243486,1540243486,아톰헤어,1,1,1,3
5378,s20836285,20836285,연이헤어,1,1,1,3
5379,s36174652,36174652,M헤어네일,1,1,1,3
5380,s37647903,37647903,NO1 Boram,1,1,1,3
5381,s20625103,20625103,머리휘,1,1,1,3
5382,s20855633,20855633,제이헤어,1,1,1,3
5383,s20824575,20824575,금의랑헤어샵,1,1,1,3
5384,s1070157752,1070157752,머리할때됐다,1,1,1,3
5385,s20905670,20905670,스타헤어,1,1,1,3
5386,s1018691023,1018691023,성은미용실,1,1,1,3
5387,s17900652,17900652,나나미용실,1,1,1,3
5388,s20924814,20924814,박미자헤어샵,1,1,1,3
5389,s34405955,34405955,윤미옥헤어리즘,1,1,1,3
5390,s1455185672,1455185672,승리헤어,1,1,1,3
5391,s1949414045,1949414045,승리미용실,1,1,1,3
5392,s1876873867,1876873867,보노헤어,1,1,1,3
5393,s1195192296,1195192296,Lee헤어,1,1,1,3
5394,s35117481,35117481,복헤어,1,1,1,3
5395,s20635969,20635969,기분좋은날,1,1,1,3
5396,s20916951,20916951,헤어체인지,1,1,1,3
5397,s36654855,36654855,헤어에스,1,1,1,3
5398,s1721027892,1721027892,허지원머리나라,1,1,1,3
5399,s37620965,37620965,윤새아헤어,1,1,1,3
5400,s37942590,37942590,봉주르헤어,1,1,1,3
5401,s1088142064,1088142064,헤어명가,1,1,1,3
5402,s1018478740,1018478740,헤어프레소,1,1,1,3
5403,s1091420107,1091420107,고운헤어샾,1,1,1,3
5404,s1277326128,1277326128,뷔헤어샵,1,1,1,3
5405,s38312356,38312356,김송정머리터 영등포점,1,1,1,3
5406,s20848210,20848210,지우헤어,1,1,1,3
5407,s1361879054,1361879054,염색하러갈까,1,1,1,3
5408,s1231341238,1231341238,주변머리미용실,1,1,1,3
5409,s20886623,20886623,뽀그리헤어,1,1,1,3
5410,s20867787,20867787,오경희헤어,1,1,1,3
5411,s30886710,30886710,영희미용실,1,1,1,3
5412,s20928343,20928343,현헤어,1,1,1,3
5413,s33636603,33636603,민찬뷰티헤어작,1,1,1,3
5414,s1173114430,1173114430,더스타일헤어,1,1,1,3
5415,s1993469355,1993469355,사랑미용실,1,1,1,3
5416,s1878862909,1878862909,아네스헤어,1,1,1,3
5417,s34087215,34087215,카토샵,1,1,1,3
5418,s34604398,34604398,까도남커트클럽,1,1,1,3
5419,s1661007273,1661007273,BK헤어샵,1,1,1,3
5420,s313022824,313022824,코코미용실,1,1,1,3
5421,s1132229321,1132229321,만미미용실,1,1,1,3
5422,s35088494,35088494,로젠탈헤어,1,1,1,3
5423,s20917541,20917541,머리까끼,1,1,1,3
5424,s19018026,19018026,로즈헤어샵,1,1,1,3
5425,s1879073324,1879073324,이화토탈뷰티샵,1,1,1,3
5426,s1486293420,1486293420,헤어톡톡,1,1,1,3
5427,s20918790,20918790,에이치스타일,1,1,1,3
5428,s18687519,18687519,소순헤어리빙,1,1,1,3
5429,s1528334882,1528334882,머리가 불광점,1,1,1,3
5430,s1993299278,1993299278,은혜헤어샵,1,1,1,3
5431,s36435112,36435112,해피맨미용실,1,1,1,3
5432,s37777893,37777893,뷰티헤어엔네일,1,1,1,3
5433,s37756034,37756034,디에이헤어,1,1,1,3
5434,s31393381,31393381,아이비헤어샵,1,1,1,3
5435,s1672397390,1672397390,러브헤어,1,1,1,3
5436,s20930164,20930164,헤어닷컴,1,1,1,3
5437,s18125775,18125775,신데렐라헤어펌,1,1,1,3
5438,s20926366,20926366,동경헤어샵,1,1,1,3
5439,s1957316920,1957316920,머리사랑,1,1,1,3
5440,s20884433,20884433,준헤어샵,1,1,1,3
5441,s20941560,20941560,아리아헤어,1,1,1,3
5442,s20930237,20930237,하나미용실,1,1,1,3
5443,s1613067281,1613067281,예손헤어샵,1,1,1,3
5444,s1184083355,1184083355,송관헤어,1,1,1,3
5445,s1773972236,1773972236,더헤어엘,1,1,1,3
5446,s20821981,20821981,매직헤어,1,1,1,3
5447,s20903401,20903401,썬헤어,1,1,1,3
5448,s18658666,18658666,오렌지헤어,1,1,1,3
5449,s20925896,20925896,머리해요,1,1,1,3
5450,s1492375669,1492375669,더컷,1,1,1,3
5451,s37766511,37766511,헬로우컷 구산점,1,1,1,3
5452,s1990076030,1990076030,미&미헤어,1,1,1,3
5453,s20888330,20888330,델라뷰헤어모드,1,1,1,3
5454,s37430266,37430266,김희영헤어스토리,1,1,1,3
5455,s20892028,20892028,세련헤어샵,1,1,1,3
5456,s38341802,38341802,미투헤어,1,1,1,3
5457,s20869039,20869039,명동헤어라인,1,1,1,3
5458,s641811877,641811877,오래가는헤어샵,1,1,1,3
5459,s1050701444,1050701444,서현헤어,1,1,1,3
5460,s20911172,20911172,유영주헤어샵,1,1,1,3
5461,s20830337,20830337,김영헤어필,1,1,1,3
5462,s20907512,20907512,까꺼,1,1,1,3
5463,s32435927,32435927,김도연헤어스타일,1,1,1,3
5464,s18658155,18658155,서지영미용실,1,1,1,3
5465,s20845616,20845616,다우리미용실,1,1,1,3
5466,s20918576,20918576,머리하는날,1,1,1,3
5467,s1234777718,1234777718,변미순미용실,1,1,1,3
5468,s11730324,11730324,블루클럽 구산동점,1,1,1,3
5469,s38325196,38325196,렉스헤어,1,1,1,3
5470,s1577664152,1577664152,최은미용실,1,1,1,3
5471,s13395260,13395260,헤어콕 연신내점,1,1,1,3
5472,s1878832544,1878832544,루디아헤어,1,1,1,3
5473,s20941623,20941623,박초희헤어클릭,1,1,1,3
5474,s20834375,20834375,BS헤어갤러리,1,1,1,3
5475,s1466189878,1466189878,HS헤어,1,1,1,3
5476,s1273508106,1273508106,신언주헤어샵,1,1,1,3
5477,s20903114,20903114,컷트매니아,1,1,1,3
5478,s20865035,20865035,큰빛헤어샵,1,1,1,3
5479,s1396243698,1396243698,유채희헤어,1,1,1,3
5480,s18662568,18662568,최희헤어,1,1,1,3
5481,s20937550,20937550,문영선헤어,1,1,1,3
5482,s20903137,20903137,안나헤어,1,1,1,3
5483,s20922065,20922065,조은헤어스튜디오,1,1,1,3
5484,s34351088,34351088,현대헤어샵,1,1,1,3
5485,s1660833783,1660833783,헤어 피어나,1,1,1,3
5486,s34355100,34355100,사라헤어아트,1,1,1,3
5487,s1039936402,1039936402,샤크헤어,1,1,1,3
5488,s894374692,894374692,옻안타는천연염색 대조점,1,1,1,3
5489,s1662538033,1662538033,Mc헤어스토리,1,1,1,3
5490,s20826328,20826328,로제헤어,1,1,1,3
5491,sk1310180507,k1310180507,헤어&드레스,1,1,1,3
5492,s888132026,888132026,SALON5 HAIR,1,1,1,3
5493,s36642190,36642190,수헤어,1,1,1,3
5494,s1961803487,1961803487,헤라,1,1,1,3
5495,s1255868262,1255868262,리헤어,1,1,1,3
5496,s20876602,20876602,스타일리스트,1,1,1,3
5497,s18666369,18666369,호수미용실,1,1,1,3
5498,s1564611410,1564611410,더두레헤어,1,1,1,3
5499,s1579506639,1579506639,헤어스타일와이,1,1,1,3
5500,s21403079,21403079,박진헤어,1,1,1,3
5501,s13029279,13029279,카시아미용실,1,1,1,3
5502,s20880310,20880310,카시아역촌점,1,1,1,3
5503,s20941317,20941317,GJ신우헤어,1,1,1,3
5504,s18663583,18663583,헤어갤러리미용실,1,1,1,3
5505,s1224773641,1224773641,조희진헤어샵,1,1,1,3
5506,s1897771823,1897771823,머리쟁이,1,1,1,3
5507,s1643506246,1643506246,뷰티샵헤어플러스,1,1,1,3
5508,s20849487,20849487,서연헤어플러스,1,1,1,3
5509,s18673018,18673018,뉴헤어,1,1,1,3
5510,s1880060117,1880060117,보나헤어,1,1,1,3
5511,s18663574,18663574,헤어매니아,1,1,1,3
5512,s1232394102,1232394102,2021,1,1,1,3
5513,s37847406,37847406,루시헤어BY소현,1,1,1,3
5514,s18676253,18676253,서울미용실,1,1,1,3
5515,s20907490,20907490,진헤어갤러리,1,1,1,3
5516,s18676009,18676009,진미용실,1,1,1,3
5517,s98236097,98236097,윤헤어,1,1,1,3
5518,s1289451591,1289451591,지유헤어,1,1,1,3
5519,s18083906,18083906,자쓰리헤어 은평구청점,1,1,1,3
5520,s1186795534,1186795534,헤어살롱 이레네,1,1,1,3
5521,s20813416,20813416,헤어변신클럽,1,1,1,3
5522,s18686458,18686458,장정수헤어샵,1,1,1,3
5523,s20834257,20834257,칼라미용실,1,1,1,3
5524,s18138024,18138024,최리헤어샵,1,1,1,3
5525,s1259426747,1259426747,샬롬미용실,1,1,1,3
5526,s20860943,20860943,참뉴스헤어샵,1,1,1,3
5527,s18682876,18682876,현지헤어샵,1,1,1,3
5528,s1972214115,1972214115,박선영헤어,1,1,1,3
5529,s18102999,18102999,신남철헤어컬렉션,1,1,1,3
5530,s18685035,18685035,한수정미용실,1,1,1,3
5531,s15001339,15001339,수현헤어,1,1,1,3
5532,s20907445,20907445,헤어도우미미용실,1,1,1,3
5533,s20845737,20845737,인애헤어클리닉,1,1,1,3
5534,s18089230,18089230,장은경머리사랑,1,1,1,3
5535,s20830298,20830298,진선헤어컬렉션,1,1,1,3
5536,s1474715738,1474715738,선헤어샵,1,1,1,3
5537,s11715973,11715973,헤어살롱 B&G 역촌점,1,1,1,3
5538,s18673558,18673558,김명숙미용실,1,1,1,3
5539,s1042711484,1042711484,주헤어,1,1,1,3
5540,s20933683,20933683,헤어골드샵연신내불광점,1,1,1,3
5541,s1489522036,1489522036,수아헤어,1,1,1,3
5542,s19419445,19419445,새한미용실,1,1,1,3
5543,s20941100,20941100,선경헤어라인,1,1,1,3
5544,s18661292,18661292,조이미용실,1,1,1,3
5545,s1071017121,1071017121,하나미용실,1,1,1,3
5546,s1255494995,1255494995,킴앤헤어,1,1,1,3
5547,s1400320042,1400320042,PERMCUT,1,1,1,3
5548,s18662978,18662978,희미용실,1,1,1,3
5549,s1327360463,1327360463,김시원헤어,1,1,1,3
5550,s1656165497,1656165497,헤어승,1,1,1,3
5551,s1158746384,1158746384,지니헤어,1,1,1,3
5552,s18121139,18121139,KMJ헤어라인,1,1,1,3
5553,s1274170720,1274170720,1헤어,1,1,1,3
5554,s18670493,18670493,노자영미용실,1,1,1,3
5555,s1573757821,1573757821,노블미용실,1,1,1,3
5556,s1430928875,1430928875,수연미용실,1,1,1,3
5557,s1151322409,1151322409,머리사랑권민지,1,1,1,3
5558,s38255367,38255367,헤어 그리고,1,1,1,3
5559,s36620781,36620781,박영숙헤어,1,1,1,3
5560,s1612676016,1612676016,아비아헤어,1,1,1,3
5561,s18670795,18670795,배숙자헤어갤러리,1,1,1,3
5562,s37417782,37417782,1021뷰티라운지,1,1,1,3
5563,s38575362,38575362,바베네헤어살롱,1,1,1,3
5564,s1318307514,1318307514,블리스박철헤어 은평병원점,1,1,1,3
5565,s1197143643,1197143643,살롱드메이트,1,1,1,3
5566,s34352856,34352856,송헤어,1,1,1,3
5567,s11730339,11730339,블루클럽 응암시장점,1,1,1,3
5568,s1522385986,1522385986,다온헤어,1,1,1,3
5569,s1337604100,1337604100,개성시대미용실,1,1,1,3
5570,s1432824252,1432824252,아이헤어,1,1,1,3
5571,s20918515,20918515,맨투맨응암점,1,1,1,3
5572,s31391763,31391763,수헤어,1,1,1,3
5573,s1058788770,1058788770,리본헤어,1,1,1,3
5574,s13093380,13093380,아루마루헤어,1,1,1,3
5575,s1440728761,1440728761,비쥬헤어,1,1,1,3
5576,s38632443,38632443,마로별헤어,1,1,1,3
5577,s20880262,20880262,연주헤어모드,1,1,1,3
5578,s1425127221,1425127221,채지언헤어,1,1,1,3
5579,s34079141,34079141,마들렌수애경헤어,1,1,1,3
5580,s1392492684,1392492684,J2헤어,1,1,1,3
5581,s18681111,18681111,이인숙헤어샵,1,1,1,3
5582,s1186553235,1186553235,이지헤어,1,1,1,3
5583,s20838177,20838177,승진헤어샵,1,1,1,3
5584,s20876376,20876376,가위소리미용실,1,1,1,3
5585,s18688100,18688100,헤어코디,1,1,1,3
5586,s741958307,741958307,이민우미용실,1,1,1,3
5587,s18675203,18675203,헤어투페이스,1,1,1,3
5588,s20825921,20825921,영헤어센스,1,1,1,3
5589,s20841971,20841971,안스헤어뱅크,1,1,1,3
5590,s1195514776,1195514776,김성희헤어샵,1,1,1,3
5591,s18678463,18678463,가인헤어,1,1,1,3
5592,s18680537,18680537,헤어씨티,1,1,1,3
5593,s18670328,18670328,머리해,1,1,1,3
5594,s20899635,20899635,엔다미용실,1,1,1,3
5595,s20926145,20926145,커티샥헤어,1,1,1,3
5596,s20845515,20845515,봄헤어,1,1,1,3
5597,s18687042,18687042,이화미용실,1,1,1,3
5598,s12001627,12001627,미헤어코코,1,1,1,3
5599,s1252229355,1252229355,미유헤어,1,1,1,3
5600,s861558914,861558914,마르셀헤어,1,1,1,3
5601,s20903385,20903385,맨투맨증산점,1,1,1,3
5602,s18130146,18130146,최진헤어,1,1,1,3
5603,s1871343865,1871343865,미가미용실,1,1,1,3
5604,s31729604,31729604,Hair헤어두,1,1,1,3
5605,s31396737,31396737,에스헤어,1,1,1,3
5606,s260939997,260939997,라푼젤미용실,1,1,1,3
5607,s34351077,34351077,피쉬헤어,1,1,1,3
5608,s1849533408,1849533408,쿨헤어,1,1,1,3
5609,s1471125660,1471125660,남성컷트간지,1,1,1,3
5610,s1351399508,1351399508,Hair andy,1,1,1,3
5611,s31562265,31562265,자이미장원,1,1,1,3
5612,s31661536,31661536,뮤즈헤어,1,1,1,3
5613,s38563234,38563234,글로리아,1,1,1,3
5614,s1209281298,1209281298,한스미용실,1,1,1,3
5615,s1595969374,1595969374,큐사랑천연염색 응암점,1,1,1,3
5616,s34352733,34352733,찬헤어,1,1,1,3
5617,s1134097793,1134097793,유니헤어,1,1,1,3
5618,s33331619,33331619,나비헤어,1,1,1,3
5619,s34084396,34084396,머리못하는집은평뉴타운점,1,1,1,3
5620,s1028660292,1028660292,헤어데이,1,1,1,3
5621,s1829474906,1829474906,이레헤어,1,1,1,3
5622,s1416201165,1416201165,헤어끌레시아,1,1,1,3
5623,sk1098844570,k1098844570,이발소,1,1,1,3
5624,s1152218843,1152218843,제이헤어샵,1,1,1,3
5625,s20876332,20876332,마리헤어,1,1,1,3
5626,s20876748,20876748,헤어꼬뽈라,1,1,1,3
5627,s33252501,33252501,헤어살롱H,1,1,1,3
5628,s20267049,20267049,헤어리치,1,1,1,3
5629,s1525634241,1525634241,J2헤어,1,1,1,3
5630,s37195513,37195513,Y헤어,1,1,1,3
5631,s1370519810,1370519810,커틸다헤어살롱 은평점,1,1,1,3
5632,s31392060,31392060,송헤어살롱,1,1,1,3
5633,s1436230319,1436230319,수헤어컷,1,1,1,3
5634,s31391738,31391738,신스헤어,1,1,1,3
5635,s31393831,31393831,써니헤어,1,1,1,3
5636,s1912531251,1912531251,예인헤어,1,1,1,3
5637,s38703864,38703864,쿨맨헤어,1,1,1,3
5638,s34353304,34353304,은헤어,1,1,1,3
5639,s1533749837,1533749837,숙희헤어,1,1,1,3
5640,s34351384,34351384,이레헤어디자인,1,1,1,3
5641,s34354111,34354111,인디헤어,1,1,1,3
5642,s1694097052,1694097052,태후사랑 신사점,1,1,1,3
5643,s34309095,34309095,윤헤어 미용실,1,1,1,3
5644,s1572055244,1572055244,JS헤어,1,1,1,3
5645,s34027498,34027498,르블랑헤어살롱,1,1,1,3
5646,s35156129,35156129,달콤헤어,1,1,1,3
5647,s1167441643,1167441643,헤어유,1,1,1,3
5648,s1715791664,1715791664,해밀헤어,1,1,1,3
5649,s1743214791,1743214791,헤어캣츠연신내점,1,1,1,3
5650,s35365901,35365901,프라하,1,1,1,3
5651,s1415399916,1415399916,박지수의 머리여행,1,1,1,3
5652,s38490244,38490244,더끌림,1,1,1,3
5653,s37430799,37430799,Hair Fit,1,1,1,3
5654,s35896317,35896317,라움헤어,1,1,1,3
5655,s1369708226,1369708226,피오레헤어,1,1,1,3
5656,s33706948,33706948,끌림 헤어스토리,1,1,1,3
5657,s1198190121,1198190121,제니헤어,1,1,1,3
5658,s34352567,34352567,김소희헤어,1,1,1,3
5659,s1710291302,1710291302,카라헤어,1,1,1,3
5660,s31394177,31394177,지앤미헤어,1,1,1,3
5661,s37186663,37186663,다인헤어,1,1,1,3
5662,s1629175549,1629175549,태후사랑구산점,1,1,1,3
5663,s38589891,38589891,낙천주의 헤어,1,1,1,3
5664,s20865240,20865240,예쁜머리,1,1,1,3
5665,s1874459599,1874459599,미용실모리,1,1,1,3
5666,s35327193,35327193,아너스헤어,1,1,1,3
5667,s1122577524,1122577524,가위소리,1,1,1,3
5668,s1758226843,1758226843,BOBOHairSalon,1,1,1,3
5669,s1005672798,1005672798,김민희헤어,1,1,1,3
5670,s38472560,38472560,나단헤어,1,1,1,3
5671,s34352712,34352712,헤어수녹번점,1,1,1,3
5672,s37126570,37126570,어반디노헤어,1,1,1,3
5673,s15001501,15001501,헤어포커스,1,1,1,3
5674,s1273378071,1273378071,아델라헤어,1,1,1,3
5675,s18125778,18125778,빨간머리앤,1,1,1,3
5676,s1290515969,1290515969,드보라헤어,1,1,1,3
5677,s1816063637,1816063637,홍헤어,1,1,1,3
5678,s1180568878,1180568878,토마토헤어샵,1,1,1,3
5679,s37494185,37494185,랑카헤어,1,1,1,3
5680,s1035167979,1035167979,미씨헤어,1,1,1,3
5681,s1076717848,1076717848,헤어살롱인서울헤드스파,1,1,1,3
5682,s37046029,37046029,블루컷역촌점,1,1,1,3
5683,sk18083896,k18083896,정헤어숍,1,1,1,3
5684,s1689145534,1689145534,예란헤어,1,1,1,3
5685,s1926558525,1926558525,젠틀맨헤어,1,1,1,3
5686,s36270967,36270967,소풍Hair,1,1,1,3
5687,s20876711,20876711,헤어PLUS,1,1,1,3
5688,s1718433685,1718433685,최윤서헤어샵,1,1,1,3
5689,s20841926,20841926,로즈헤어샵,1,1,1,3
5690,s37275096,37275096,프라이빗헤어,1,1,1,3
5691,s1640576611,1640576611,카시아헤어,1,1,1,3
5692,s1673229174,1673229174,머릿결사랑 응암2호점,1,1,1,3
5693,s18659629,18659629,버르장머리,1,1,1,3
5694,s20892072,20892072,이철헤어비스,1,1,1,3
5695,s20310719,20310719,이덕란미용실,1,1,1,3
5696,s20466998,20466998,경헤어아트,1,1,1,3
5697,s20937675,20937675,모던헤어,1,1,1,3
5698,s1211169907,1211169907,김혜란헤어아트,1,1,1,3
5699,s21294067,21294067,스타일헤어,1,1,1,3
5700,s20846069,20846069,정아헤어갤러리,1,1,1,3
5701,s1289460844,1289460844,블레이드헤어역촌점,1,1,1,3
5702,s18669278,18669278,이정헤어샵,1,1,1,3
5703,s1411304738,1411304738,로뎀헤어,1,1,1,3
5704,s1539420564,1539420564,가위소리,1,1,1,3
5705,s18681245,18681245,라피네헤어클럽,1,1,1,3
5706,s20488248,20488248,아이즈헤어,1,1,1,3
5707,s18684026,18684026,루루미용실,1,1,1,3
5708,s805100900,805100900,샵헤어,1,1,1,3
5709,s20874833,20874833,센스쟁이,1,1,1,3
5710,s1190638405,1190638405,수미용실,1,1,1,3
5711,s1215823954,1215823954,현헤어스케치,1,1,1,3
5712,s1855136256,1855136256,살롱드소이,1,1,1,3
5713,s1182146395,1182146395,슈보헤어,1,1,1,3
5714,s36523302,36523302,디보트헤어,1,1,1,3
5715,s18678763,18678763,헤어두,1,1,1,3
5716,s36643664,36643664,포레스트헤어,1,1,1,3
5717,s38642644,38642644,헤이미쉬헤어,1,1,1,3
5718,s1661382280,1661382280,경헤어클럽,1,1,1,3
5719,s1736390646,1736390646,목련미용실,1,1,1,3
5720,s1342142727,1342142727,수컬렉션,1,1,1,3
5721,s1382692509,1382692509,디베르헤어,1,1,1,3
5722,s20911029,20911029,서원헤어샵,1,1,1,3
5723,s20842046,20842046,봄날,1,1,1,3
5724,s18678192,18678192,다우리미용실,1,1,1,3
5725,s20849733,20849733,재임헤어모드,1,1,1,3
5726,s35346668,35346668,헤어바이초이,1,1,1,3
5727,s1339106629,1339106629,더진헤어,1,1,1,3
5728,s20888409,20888409,여우꼬리헤어샵,1,1,1,3
5729,s18676440,18676440,여화모본점,1,1,1,3
5730,s1641143369,1641143369,루아헤어&스토어 응암점,1,1,1,3
5731,s1794809570,1794809570,한나헤어샵,1,1,1,3
5732,s34354162,34354162,SERENAHUS헤어드레싱,1,1,1,3
5733,s1107050610,1107050610,베아트리스헤어샵,1,1,1,3
5734,s20868845,20868845,윤슬헤어,1,1,1,3
5735,s20892194,20892194,헤어뱅크,1,1,1,3
5736,s18673674,18673674,제니헤어,1,1,1,3
5737,s19476755,19476755,린헤어,1,1,1,3
5738,s20830248,20830248,헤어보그,1,1,1,3
5739,s20941353,20941353,세희헤어,1,1,1,3
5740,s20826167,20826167,JM헤어갤러리,1,1,1,3
5741,s20486301,20486301,셀리나허스헤어드레싱,1,1,1,3
5742,s20853615,20853615,정혜영헤어큐,1,1,1,3
5743,s20918662,20918662,짱헤어라인,1,1,1,3
5744,s34351085,34351085,빌리지헤어,1,1,1,3
5745,s1072249395,1072249395,행복미용실,1,1,1,3
5746,s1521832571,1521832571,유라헤어,1,1,1,3
5747,s20934026,20934026,고은헤어,1,1,1,3
5748,s18663898,18663898,무지개미용실,1,1,1,3
5749,s18666208,18666208,쎄씨헤어,1,1,1,3
5750,s20838032,20838032,하이헤어,1,1,1,3
5751,s1194741185,1194741185,닥터헤어,1,1,1,3
5752,s1825374070,1825374070,수놓은머리결,1,1,1,3
5753,s20934055,20934055,유주아HAIR,1,1,1,3
5754,s20934086,20934086,FOR헤어,1,1,1,3
5755,s18677033,18677033,스마일헤어,1,1,1,3
5756,s20918675,20918675,머리치장,1,1,1,3
5757,s37107682,37107682,헤어스케치,1,1,1,3
5758,s1288623751,1288623751,조앤리헤어,1,1,1,3
5759,s1641006779,1641006779,조앤리헤어,1,1,1,3
5760,s20861367,20861367,머리이야기,1,1,1,3
5761,s20860980,20860980,미공간헤어,1,1,1,3
5762,s1987047285,1987047285,김현숙헤어,1,1,1,3
5763,s20845996,20845996,제이엠헤어필,1,1,1,3
5764,s20907258,20907258,티앤헤어,1,1,1,3
5765,s20861456,20861456,마오노헤어,1,1,1,3
5766,s34352660,34352660,THEARA,1,1,1,3
5767,s34436337,34436337,엣지가위,1,1,1,3
5768,s35438855,35438855,블루클럽 은평뉴타운점,1,1,1,3
5769,s1879369096,1879369096,코코헤어,1,1,1,3
5770,s1092248255,1092248255,까꼬뽀꼬,1,1,1,3
5771,s20830494,20830494,꽃잎머리,1,1,1,3
5772,s20891997,20891997,수빈미용실,1,1,1,3
5773,s18660354,18660354,지선미용실,1,1,1,3
5774,s18661331,18661331,정정란헤어샾,1,1,1,3
5775,s33657050,33657050,미정헤어,1,1,1,3
5776,s20762374,20762374,라벨라미용실,1,1,1,3
5777,s18136751,18136751,마린헤어,1,1,1,3
5778,s1254631000,1254631000,엘라헤어,1,1,1,3
5779,s1785786110,1785786110,초콜렛헤어,1,1,1,3
5780,s1304214281,1304214281,글로리아헤어,1,1,1,3
5781,s1145083426,1145083426,헤어스케치,1,1,1,3
5782,s36992234,36992234,MANA HAIR,1,1,1,3
5783,s18669119,18669119,가위소리헤어샵,1,1,1,3
5784,s36536803,36536803,요시하라메이코,1,1,1,3
5785,s917736466,917736466,헤어제니,1,1,1,3
5786,s32855611,32855611,머리가 예쁜 사람들,1,1,1,3
5787,s1487042273,1487042273,칼라헤어뱅크,1,1,1,3
5788,s1523598019,1523598019,헤어체인지,1,1,1,3
5789,s1514240697,1514240697,수민미용실,1,1,1,3
5790,s32180182,32180182,금가위소리미용실,1,1,1,3
5791,s1037017110,1037017110,까끄미조아,1,1,1,3
5792,s20937676,20937676,미앤미,1,1,1,3
5793,s18667274,18667274,소라미용실,1,1,1,3
5794,s18664963,18664963,주리헤어,1,1,1,3
5795,s1165645202,1165645202,착한미용실원투쓰리,1,1,1,3
5796,s1146097301,1146097301,행복한사람들,1,1,1,3
5797,s1178043955,1178043955,이모네미용실,1,1,1,3
5798,s20826260,20826260,정금당미용실,1,1,1,3
5799,s1020749896,1020749896,몽니스샵,1,1,1,3
5800,s1332504318,1332504318,라임헤어,1,1,1,3
5801,s20849591,20849591,해원펌&컷,1,1,1,3
5802,s1211992476,1211992476,남은정헤어아트,1,1,1,3
5803,s18667817,18667817,숙모드헤어,1,1,1,3
5804,s34350896,34350896,진헤어포토미용실,1,1,1,3
5805,s1186914635,1186914635,홍샘헤어,1,1,1,3
5806,s1040224593,1040224593,머리몽땅,1,1,1,3
5807,s549259138,549259138,에스더헤어,1,1,1,3
5808,s1707642996,1707642996,살롱드프롬 연신내2호점,1,1,1,3
5809,s1821817275,1821817275,고고헤어갈현점,1,1,1,3
5810,s1680841875,1680841875,엘헤어,1,1,1,3
5811,s1403842590,1403842590,귀애헤어,1,1,1,3
5812,s1711997164,1711997164,강미용실,1,1,1,3
5813,s20891678,20891678,유미미용실,1,1,1,3
5814,s20934012,20934012,애경뷰티클럽,1,1,1,3
5815,s20857390,20857390,미란DK미용실,1,1,1,3
5816,s1186711455,1186711455,민헤어네일,1,1,1,3
5817,s20918282,20918282,녹색머리,1,1,1,3
5818,s18664334,18664334,희미용실,1,1,1,3
5819,s18678983,18678983,민머리방,1,1,1,3
5820,s1223927681,1223927681,조이미용실,1,1,1,3
5821,s18113279,18113279,헤어갤러리24번가,1,1,1,3
5822,s1172485379,1172485379,화원헤어샵,1,1,1,3
5823,s20941450,20941450,칼라친구들,1,1,1,3
5824,s1371455939,1371455939,임마누엘헤어아트,1,1,1,3
5825,s37881541,37881541,LENA헤어,1,1,1,3
5826,s1198576446,1198576446,펌이랑컷헤어,1,1,1,3
5827,s18678748,18678748,윤미용실,1,1,1,3
5828,s36936178,36936178,세라헤어샵,1,1,1,3
5829,s18039464,18039464,방정남헤어예술촌,1,1,1,3
5830,s18138000,18138000,고추잠자리미용실,1,1,1,3
5831,s18107514,18107514,김경숙미용실,1,1,1,3
5832,s1216252583,1216252583,짤라뽀까미용실,1,1,1,3
5833,s33253653,33253653,문정단헤어갤러리,1,1,1,3
5834,s20892058,20892058,모드니머리방,1,1,1,3
5835,s10982257,10982257,백합 미용실,1,1,1,3
5836,s20914940,20914940,박성림헤어리드,1,1,1,3
5837,s18662528,18662528,유지연미용실,1,1,1,3
5838,s1068941332,1068941332,느낌표헤어,1,1,1,3
5839,s18676847,18676847,씨앤씨헤어클럽,1,1,1,3
5840,s1880212808,1880212808,포맨남성컷트클럽,1,1,1,3
5841,s1440343221,1440343221,LW헤어,1,1,1,3
5842,s18141630,18141630,미리네미용실,1,1,1,3
5843,s367258260,367258260,도란도란헤어샵,1,1,1,3
5844,s20822146,20822146,젤라미용실,1,1,1,3
5845,s20901576,20901576,민희미용실,1,1,1,3
5846,s786712083,786712083,에클라헤어,1,1,1,3
5847,s1715399102,1715399102,가인헤어,1,1,1,3
5848,s37896366,37896366,더라인헤어,1,1,1,3
5849,s1298078887,1298078887,별헤어샵,1,1,1,3
5850,s1055221169,1055221169,더라움헤어,1,1,1,3
5851,s1085507559,1085507559,카라헤어,1,1,1,3
5852,s1495671398,1495671398,바바헤어샵,1,1,1,3
5853,s15001500,15001500,까까머리,1,1,1,3
5854,s20822017,20822017,윤헤어필,1,1,1,3
5855,s1670621095,1670621095,올드클리퍼앤드시저스,1,1,1,3
5856,s864412598,864412598,헤어샾,1,1,1,3
5857,s1206432498,1206432498,카시아미용실,1,1,1,3
5858,s1049458605,1049458605,체인지헤어샵 은평점,1,1,1,3
5859,s1157025437,1157025437,김혜리헤어아트,1,1,1,3
5860,s18097602,18097602,써니헤어아트,1,1,1,3
5861,s1344509569,1344509569,정가인헤어,1,1,1,3
5862,s18684690,18684690,혜승헤어,1,1,1,3
5863,s34351608,34351608,헤어란,1,1,1,3
5864,s20907448,20907448,까꼬뽀꼬미용실,1,1,1,3
5865,s1366223670,1366223670,라브리지헤어살롱,1,1,1,3
5866,s18107526,18107526,서원미용실,1,1,1,3
5867,s1085171673,1085171673,참헤어샵,1,1,1,3
5868,s20911136,20911136,진영헤어라인,1,1,1,3
5869,s1491165679,1491165679,소영헤어,1,1,1,3
5870,s20914883,20914883,서승희헤어샵,1,1,1,3
5871,s20857472,20857472,문희머리연출,1,1,1,3
5872,s18675021,18675021,글로리미용실,1,1,1,3
5873,s15001014,15001014,연신미용실,1,1,1,3
5874,s20845499,20845499,고은미용타운,1,1,1,3
5875,s755243124,755243124,Blossom by kiwon,1,1,1,3
5876,s35689410,35689410,머리하는날,1,1,1,3
5877,s18107543,18107543,동명헤어스케치,1,1,1,3
5878,s20830469,20830469,까까머리,1,1,1,3
5879,s20892162,20892162,제이헤어,1,1,1,3
5880,s1819219865,1819219865,카라헤어,1,1,1,3
5881,s20926326,20926326,컷하우스,1,1,1,3
5882,s1889564518,1889564518,미파헤어필,1,1,1,3
5883,s986697018,986697018,헤어겔러리,1,1,1,3
5884,s1334280351,1334280351,윤지헤어,1,1,1,3
5885,s1136327160,1136327160,다미헤어,1,1,1,3
5886,s20872774,20872774,윤재헤어,1,1,1,3
5887,s1238919665,1238919665,은헤어,1,1,1,3
5888,s20880694,20880694,가연헤어샵,1,1,1,3
5889,s18687760,18687760,김지현헤어마술사,1,1,1,3
5890,s20884153,20884153,헤어스케치,1,1,1,3
5891,s20922542,20922542,장수미용실,1,1,1,3
5892,s1060041345,1060041345,영헤어샵,1,1,1,3
5893,s31393919,31393919,헤어스튜디오공감,1,1,1,3
5894,s20918736,20918736,가람헤어아트,1,1,1,3
5895,s1018627154,1018627154,성심미용실,1,1,1,3
5896,s20911229,20911229,화려한외출준비미용실,1,1,1,3
5897,s18691386,18691386,수빈헤어필,1,1,1,3
5898,s1142949873,1142949873,블루헤어샵,1,1,1,3
5899,s20834337,20834337,간지남,1,1,1,3
5900,s1222912427,1222912427,미즈머리까끼,1,1,1,3
5901,s1456600672,1456600672,제이제이헤어,1,1,1,3
5902,s1039589034,1039589034,명동미용실,1,1,1,3
5903,s18107506,18107506,둥지미용실,1,1,1,3
5904,s18664375,18664375,유성미용타운,1,1,1,3
5905,s1922463936,1922463936,OLhair,1,1,1,3
5906,s37753545,37753545,MINE Hair Atelier,1,1,1,3
5907,s20845959,20845959,현미용실,1,1,1,3
5908,s1682756243,1682756243,우리미용실,1,1,1,3
5909,s1056411192,1056411192,헤라헤어,1,1,1,3
5910,s1061270362,1061270362,최정임헤어,1,1,1,3
5911,s20903493,20903493,하나미용실,1,1,1,3
5912,s20903246,20903246,동원헤어센스,1,1,1,3
5913,s18676287,18676287,제일미용실,1,1,1,3
5914,s37249402,37249402,벨르헤어,1,1,1,3
5915,s20914950,20914950,해와달헤어샵,1,1,1,3
5916,s20830375,20830375,헤어해요,1,1,1,3
5917,s1098337582,1098337582,헤어아델라,1,1,1,3
5918,s1390335647,1390335647,헤어준,1,1,1,3
5919,s37852824,37852824,김연정헤어솔라,1,1,1,3
5920,s888916803,888916803,수헤어샵,1,1,1,3
5921,s1996334430,1996334430,헤어스케치,1,1,1,3
5922,s20910862,20910862,보리헤어샵,1,1,1,3
5923,s1793544531,1793544531,머리마당,1,1,1,3
5924,s31391252,31391252,호호헤어,1,1,1,3
5925,s1475343091,1475343091,리아라인헤어,1,1,1,3
5926,s18658910,18658910,현대머리방,1,1,1,3
5927,s20853236,20853236,다은헤어,1,1,1,3
5928,s20880575,20880575,궁전미용실,1,1,1,3
5929,s1235055269,1235055269,이레헤어,1,1,1,3
5930,s20941582,20941582,두발은자유,1,1,1,3
5931,s20845992,20845992,헤어플러스,1,1,1,3
5932,s20892140,20892140,정미헤어,1,1,1,3
5933,s20876734,20876734,세은머리방,1,1,1,3
5934,s37413813,37413813,민제이헤어,1,1,1,3
5935,s18676447,18676447,빨강머리,1,1,1,3
5936,s36547332,36547332,H ON Hair,1,1,1,3
5937,s35906294,35906294,레브헤어,1,1,1,3
5938,s1629061054,1629061054,샤르망헤어,1,1,1,3
5939,s1375337828,1375337828,박민정미용실,1,1,1,3
5940,s323714095,323714095,모던헤어,1,1,1,3
5941,s20499019,20499019,원미용실,1,1,1,3
5942,s20876716,20876716,아트헤어샵,1,1,1,3
5943,s32174725,32174725,도로시헤어샵,1,1,1,3
5944,s20868781,20868781,유천헤어플러스,1,1,1,3
5945,s20933615,20933615,준미용실,1,1,1,3
5946,s18692796,18692796,라임헤어,1,1,1,3
5947,s1233507294,1233507294,박인아헤어플러스,1,1,1,3
5948,s20857315,20857315,조강이헤어샵,1,1,1,3
5949,s20911070,20911070,헤어아트,1,1,1,3
5950,s20892061,20892061,헤어나라미용실,1,1,1,3
5951,s1363464274,1363464274,한마음헤어,1,1,1,3
5952,s1684883758,1684883758,커트클럽 은평신사점,1,1,1,3
5953,s1688055739,1688055739,정헤어,1,1,1,3
5954,s36793169,36793169,에제키엘,1,1,1,3
5955,s18688216,18688216,서예린헤어샵,1,1,1,3
5956,s1341449053,1341449053,청춘헤어,1,1,1,3
5957,s20841715,20841715,헤어힐링랩,1,1,1,3
5958,s20891924,20891924,무지개미용실,1,1,1,3
5959,s20861304,20861304,영재미용실,1,1,1,3
5960,s1190775754,1190775754,예쁜머리,1,1,1,3
5961,s169667256,169667256,헤어커커,1,1,1,3
5962,s20899337,20899337,은혜헤어모드,1,1,1,3
5963,s1679032558,1679032558,목화헤어샵,1,1,1,3
5964,s20849748,20849748,다솜헤어숍,1,1,1,3
5965,s12924636,12924636,헤어살롱비앤지 연신내1호점,1,1,1,3
5966,s20834334,20834334,준미용실,1,1,1,3
5967,s36961247,36961247,아루헤어비스,1,1,1,3
5968,s1752027431,1752027431,승아헤어,1,1,1,3
5969,s20903424,20903424,주희헤어크럽,1,1,1,3
5970,s90196467,90196467,디온헤어,1,1,1,3
5971,s1135743794,1135743794,끌림헤어,1,1,1,3
5972,s20910856,20910856,MaTa,1,1,1,3
5973,s20834107,20834107,아르떼헤어,1,1,1,3
5974,s314803508,314803508,유헤어,1,1,1,3
5975,s20868995,20868995,헤어클릭,1,1,1,3
5976,s33831206,33831206,in헤어샵,1,1,1,3
5977,s1580589483,1580589483,핸 샵,1,1,1,3
5978,s31344669,31344669,헤어스케치,1,1,1,3
5979,s18690701,18690701,제이헤어클럽,1,1,1,3
5980,s20876872,20876872,도도헤어,1,1,1,3
5981,s1059771989,1059771989,장쌤공간,1,1,1,3
5982,s920482395,920482395,자름,1,1,1,3
5983,s1131191492,1131191492,모리미용실,1,1,1,3
5984,s20930239,20930239,아름헤어샵,1,1,1,3
5985,s36643643,36643643,숲HAIR,1,1,1,3
5986,s18688450,18688450,더퀸헤어,1,1,1,3
5987,s20941367,20941367,단헤어,1,1,1,3
5988,s20937714,20937714,가든머리방,1,1,1,3
5989,s15001168,15001168,안나미용실,1,1,1,3
5990,s37495468,37495468,예쁜머리만들기,1,1,1,3
5991,s20937275,20937275,아름헤어,1,1,1,3
5992,s1286508813,1286508813,송주영헤어,1,1,1,3
5993,s18141000,18141000,송주영미용실,1,1,1,3
5994,s20941162,20941162,뷰티미용실,1,1,1,3
5995,s38633018,38633018,온유헤어,1,1,1,3
5996,s35849033,35849033,남성컷포맨,1,1,1,3
5997,s31394845,31394845,도도미용실,1,1,1,3
5998,s20526605,20526605,까까보까,1,1,1,3
5999,s1877677271,1877677271,에일린헤어,1,1,1,3
6000,s1276034248,1276034248,샤인헤어,1,1,1,3
6001,s20907385,20907385,고우네미용실,1,1,1,3
6002,s18662260,18662260,럭스헤어,1,1,1,3
6003,s20838302,20838302,조안미용실,1,1,1,3
6004,s20865118,20865118,남성전문헤어샵,1,1,1,3
6005,s1983498883,1983498883,비너스헤어,1,1,1,3
6006,s20860957,20860957,현대미용실,1,1,1,3
6007,s1938033846,1938033846,1층 커트샾,1,1,1,3
6008,s18089232,18089232,로얄미용실,1,1,1,3
6009,s1033808994,1033808994,한헤어샵,1,1,1,3
6010,s820068442,820068442,지연헤어,1,1,1,3
6011,s20868688,20868688,연화헤어샵,1,1,1,3
6012,s34355101,34355101,머리가미용실,1,1,1,3
6013,s20868667,20868667,머리하는날,1,1,1,3
6014,s20861056,20861056,정혜정헤어모드,1,1,1,3
6015,s18660900,18660900,이화헤어아트,1,1,1,3
6016,s15001167,15001167,현대미용실,1,1,1,3
6017,s33211157,33211157,KkuMiGo,1,1,1,3
6018,s18663238,18663238,황금미용실,1,1,1,3
6019,s1790603490,1790603490,헤어포즈,1,1,1,3
6020,s18670559,18670559,샬롬머리방,1,1,1,3
6021,s1511434892,1511434892,샬롬미용실,1,1,1,3
6022,s1731851614,1731851614,머리사랑,1,1,1,3
6023,s35725326,35725326,태후사랑응암점,1,1,1,3
6024,s20822262,20822262,최머리방,1,1,1,3
6025,s20861179,20861179,헤어플러스,1,1,1,3
6026,s20937371,20937371,변승희헤어샵,1,1,1,3
6027,s32176832,32176832,헤어터치미용실,1,1,1,3
6028,s20907254,20907254,헤어가든&유,1,1,1,3
6029,s18125783,18125783,이현정머리방,1,1,1,3
6030,s18666494,18666494,헤어디제이,1,1,1,3
6031,s1691909850,1691909850,착한미용실,1,1,1,3
6032,s638514955,638514955,코지헤어,1,1,1,3
6033,s20895517,20895517,충무로투영미용실,1,1,1,3
6034,s1415357079,1415357079,이현주헤어샵,1,1,1,3
6035,s20841901,20841901,구근혜헤어아트,1,1,1,3
6036,s1904950344,1904950344,예쁜머리,1,1,1,3
6037,s1066633098,1066633098,영헤어,1,1,1,3
6038,s20892111,20892111,숙헤어갤러리,1,1,1,3
6039,s1205313541,1205313541,주아미용실,1,1,1,3
6040,s18662438,18662438,이화미용실,1,1,1,3
6041,s1405170320,1405170320,말헤어,1,1,1,3
6042,s18664247,18664247,헤어리더,1,1,1,3
6043,s1177268565,1177268565,개성시대미용실,1,1,1,3
6044,s20895859,20895859,머리가이,1,1,1,3
6045,s20853541,20853541,언덕미용실,1,1,1,3
6046,s20937261,20937261,홍파미용실,1,1,1,3
6047,s18662644,18662644,뉴마샬미용실,1,1,1,3
6048,s1985355825,1985355825,서울미용실,1,1,1,3
6049,s1392725919,1392725919,자유헤어,1,1,1,3
6050,s37844651,37844651,플로라바이이정화,1,1,1,3
6051,s1210834958,1210834958,라인헤어,1,1,1,3
6052,s1099552368,1099552368,헤어카페,1,1,1,3
6053,s18660736,18660736,진미용실,1,1,1,3
6054,s18669139,18669139,임정희헤어샵,1,1,1,3
6055,s20834240,20834240,헤어코코,1,1,1,3
6056,s1845740932,1845740932,샤론헤어,1,1,1,3
6057,s1985291258,1985291258,헤어포유,1,1,1,3
6058,s1921535246,1921535246,헤어더쿠 점핑점,1,1,1,3
6059,s36684212,36684212,W-HAIR,1,1,1,3
6060,s536170853,536170853,리앤헤어,1,1,1,3
6061,s37897811,37897811,로데오헤어,1,1,1,3
6062,s1983754355,1983754355,착한미용실,1,1,1,3
6063,s542437668,542437668,헤어포맨,1,1,1,3
6064,s18664237,18664237,행복한헤어샵,1,1,1,3
6065,s37603252,37603252,핑크퀸,1,1,1,3
6066,s11543784,11543784,박혜진 헤어갤러리,1,1,1,3
6067,s31730364,31730364,헤어체인지,1,1,1,3
6068,s35545983,35545983,헤어갤러리아,1,1,1,3
6069,s18097598,18097598,에덴미용실,1,1,1,3
6070,s12968611,12968611,헤어뉴스미용실,1,1,1,3
6071,s20926306,20926306,헤어샵지엔미,1,1,1,3
6072,s1997310166,1997310166,압구정헤어2호점,1,1,1,3
6073,s18666113,18666113,리헤어,1,1,1,3
6074,s330511260,330511260,이혜정헤어라인,1,1,1,3
6075,s1110009994,1110009994,명동미용실,1,1,1,3
6076,s1944083773,1944083773,포인트미용실,1,1,1,3
6077,s15001504,15001504,머리마을,1,1,1,3
6078,s20888367,20888367,김수연헤어샵,1,1,1,3
6079,s1982104449,1982104449,란헤어,1,1,1,3
6080,s20880483,20880483,석헤어센스,1,1,1,3
6081,s20864802,20864802,김경희헤어시그널,1,1,1,3
6082,s1766088642,1766088642,전헤어,1,1,1,3
6083,sk1275308008,k1275308008,쟈스민헤어,1,1,1,3
6084,s1555734099,1555734099,비비헤어,1,1,1,3
6085,s18662189,18662189,자매미용실,1,1,1,3
6086,s20841924,20841924,성보사미용실,1,1,1,3
6087,s18656961,18656961,머리하는날,1,1,1,3
6088,s1630345869,1630345869,헤어드림,1,1,1,3
6089,s21368173,21368173,이레네미용실,1,1,1,3
6090,s20899408,20899408,성이미용실,1,1,1,3
6091,s18687646,18687646,헤어클릭,1,1,1,3
6092,s20849751,20849751,강영숙미용실,1,1,1,3
6093,s20895497,20895497,뉴현대미용실,1,1,1,3
6094,s1095791811,1095791811,민혜진헤어라인,1,1,1,3
6095,s20857521,20857521,영산미용실,1,1,1,3
6096,s1717386846,1717386846,짱헤어,1,1,1,3
6097,s20924460,20924460,신한진헤어커커,1,1,1,3
6098,s18667280,18667280,고추잠자리,1,1,1,3
6099,s18661479,18661479,헤어뱅크,1,1,1,3
6100,s20853527,20853527,코디미용실,1,1,1,3
6101,s1061824690,1061824690,아인헤어,1,1,1,3
6102,s1938229742,1938229742,에덴헤어뉴스,1,1,1,3
6103,s20911259,20911259,헤어보그,1,1,1,3
6104,s18656256,18656256,윤슬헤어스타일,1,1,1,3
6105,s18657898,18657898,현대미용실,1,1,1,3
6106,s38325193,38325193,설레임미용실,1,1,1,3
6107,s20926146,20926146,머리만들기,1,1,1,3
6108,s1249323457,1249323457,스칼렛2호점,1,1,1,3
6109,s1838611911,1838611911,지니헤어,1,1,1,3
6110,s18672746,18672746,산수헤어샵,1,1,1,3
6111,s20941080,20941080,영아미용실,1,1,1,3
6112,s18657477,18657477,황싸롱,1,1,1,3
6113,sk18109704,k18109704,장안이발관,1,1,1,3
6114,s20864782,20864782,영미용실,1,1,1,3
6115,s20842130,20842130,성심미용실,1,1,1,3
6116,s20895635,20895635,푸르나미용실,1,1,1,3
6117,s1995617660,1995617660,머리마을,1,1,1,3
6118,s18660313,18660313,라인미용실,1,1,1,3
6119,s19792213,19792213,헤어홀릭,1,1,1,3
6120,s1326899650,1326899650,조선호텔뷰티샵,1,1,1,3
6121,s1661645536,1661645536,이가자헤어비스 서울아산병원점,1,1,1,3
6122,s11483939,11483939,미뇽헤어,1,1,1,3
6123,s20913898,20913898,윤헤어,1,1,1,3
6124,s18020398,18020398,AJ헤어,1,1,1,3
6125,s33299607,33299607,진아미용실,1,1,1,3
6126,s1510649912,1510649912,헬로우컷 송파삼전점,1,1,1,3
6127,s1448781677,1448781677,JM헤어,1,1,1,3
6128,s19570238,19570238,헤드라인미용실,1,1,1,3
6129,s1497805321,1497805321,시크헤어,1,1,1,3
6130,s20834886,20834886,타임플러스,1,1,1,3
6131,s1257394207,1257394207,오살롱,1,1,1,3
6132,s1303734820,1303734820,소라헤어샵,1,1,1,3
6133,s1752745816,1752745816,소라미용실,1,1,1,3
6134,s20904056,20904056,설응환헤어,1,1,1,3
6135,s20911609,20911609,유정헤어샵,1,1,1,3
6136,s1330643405,1330643405,배디헤어,1,1,1,3
6137,s1071711684,1071711684,이레헤어,1,1,1,3
6138,s1056272649,1056272649,구피샵 방이점,1,1,1,3
6139,s1734084564,1734084564,라올헤어,1,1,1,3
6140,s18865429,18865429,수왕헤어아트,1,1,1,3
6141,s20899375,20899375,아이리스헤어샵,1,1,1,3
6142,s18886442,18886442,백준헤어샵,1,1,1,3
6143,s20911678,20911678,박언니미용실,1,1,1,3
6144,s1468734432,1468734432,버블스토리 잠실점,1,1,1,3
6145,s1146341392,1146341392,늘헤어샵,1,1,1,3
6146,s33997351,33997351,태후사랑 풍납점,1,1,1,3
6147,s32240769,32240769,김선옥헤어,1,1,1,3
6148,s1395590070,1395590070,와이즈살롱,1,1,1,3
6149,s1139526468,1139526468,김민경헤어샵,1,1,1,3
6150,s1176458176,1176458176,PS ECO,1,1,1,3
6151,s1073559635,1073559635,미스터남성커트,1,1,1,3
6152,s1345275786,1345275786,훼밀리 헤어,1,1,1,3
6153,s1734745024,1734745024,매료헤어살롱,1,1,1,3
6154,s1333022809,1333022809,그린포레헤어,1,1,1,3
6155,s1326737570,1326737570,걍헤어샵,1,1,1,3
6156,s32240917,32240917,북창동개미미용실,1,1,1,3
6157,s1298745902,1298745902,여진헤어샵,1,1,1,3
6158,s18016547,18016547,신미용실,1,1,1,3
6159,s1897938044,1897938044,펌앤컷,1,1,1,3
6160,s20842496,20842496,창포미용실,1,1,1,3
6161,s1784581420,1784581420,태후사랑 가락2동점,1,1,1,3
6162,s1140551968,1140551968,태후사랑 가락1호점,1,1,1,3
6163,s1635212437,1635212437,제나헤어,1,1,1,3
6164,s1168953298,1168953298,사라쿨헤어커커,1,1,1,3
6165,s1259035201,1259035201,국제미용실,1,1,1,3
6166,s20922133,20922133,보라미용타운,1,1,1,3
6167,s1160087806,1160087806,엘랑미용실,1,1,1,3
6168,s1317593501,1317593501,마리아헤어,1,1,1,3
6169,s1382702664,1382702664,진헤어,1,1,1,3
6170,s18833798,18833798,헤어플러스,1,1,1,3
6171,s20884318,20884318,쎄븐미용실,1,1,1,3
6172,s1927155941,1927155941,엘랑헤어샵,1,1,1,3
6173,s18833389,18833389,짱잘헤어,1,1,1,3
6174,s20903078,20903078,미녀들의수다,1,1,1,3
6175,s1958762290,1958762290,나나헤어샵,1,1,1,3
6176,s20853182,20853182,영진미용실,1,1,1,3
6177,s1933293391,1933293391,초이스헤어,1,1,1,3
6178,s20907029,20907029,헤어센스,1,1,1,3
6179,s1414559828,1414559828,정희진헤어샵,1,1,1,3
6180,s11875307,11875307,국제헤어라인,1,1,1,3
6181,s35874596,35874596,조유빈헤어,1,1,1,3
6182,s18435999,18435999,삼광미용실,1,1,1,3
6183,s20853324,20853324,이정원헤어아트,1,1,1,3
6184,s20830182,20830182,벧엘미용실,1,1,1,3
6185,s1818322056,1818322056,김유민헤어,1,1,1,3
6186,s1090714796,1090714796,폼헤어아트,1,1,1,3
6187,s20937316,20937316,리안헤어 신월사거리점,1,1,1,3
6188,s37069894,37069894,미랑컬헤어 신월3동점,1,1,1,3
6189,s36845056,36845056,with hair,1,1,1,3
6190,s11730205,11730205,블루클럽 신월점,1,1,1,3
6191,s12854850,12854850,더헤어,1,1,1,3
6192,s20933706,20933706,마릴린먼로,1,1,1,3
6193,s20872583,20872583,헤어프로포즈,1,1,1,3
6194,s18843187,18843187,리인헤어,1,1,1,3
6195,s20887970,20887970,컷트클럽,1,1,1,3
6196,s20868690,20868690,린헤어,1,1,1,3
6197,s1724151883,1724151883,마법의손,1,1,1,3
6198,s18430356,18430356,우리미용실,1,1,1,3
6199,s1244595064,1244595064,씨씨헤어아트,1,1,1,3
6200,s20841835,20841835,헤어아트미용실,1,1,1,3
6201,s1886587934,1886587934,행운헤어샵,1,1,1,3
6202,s1812633828,1812633828,행운미용실,1,1,1,3
6203,s18832172,18832172,헤어플러스,1,1,1,3
6204,s1908214229,1908214229,헤어샵 유,1,1,1,3
6205,s20834994,20834994,블루클럽장충점,1,1,1,3
6206,s1475153027,1475153027,박양헤어샵,1,1,1,3
6207,s1905027455,1905027455,지누헤어,1,1,1,3
6208,s31367994,31367994,백설공주 hair salon,1,1,1,3
6209,s37197269,37197269,더웨이브 B롯데백화점본점,1,1,1,3
6210,s810110934,810110934,헤어코디,1,1,1,3
6211,s33752093,33752093,스타일리헤어,1,1,1,3
6212,sk1643763809,k1643763809,태후사랑,1,1,1,3
6213,s744745213,744745213,윤채헤어,1,1,1,3
6214,s1715855527,1715855527,나이스가이 문정법조타운점,1,1,1,3
6215,s12913033,12913033,엘르헤어,1,1,1,3
6216,s1486649858,1486649858,서영림헤어,1,1,1,3
6217,s11730358,11730358,블루클럽 명동점,1,1,1,3
6218,s808506520,808506520,차이헤어살롱,1,1,1,3
6219,s822543352,822543352,k&j헤어,1,1,1,3
6220,s1413962604,1413962604,태후사랑 장지점,1,1,1,3
6221,s18032209,18032209,꽁지머리,1,1,1,3
6222,s37673185,37673185,김선영미용실,1,1,1,3
6223,s1854609019,1854609019,나인헤어 2호점,1,1,1,3
6224,sk18497888,k18497888,헤어뱅크미용실,1,1,1,3
6225,s1087970651,1087970651,딜라잇헤어,1,1,1,3
6226,s13177639,13177639,블루클럽 잠실파크리오점,1,1,1,3
6227,s760817995,760817995,태후사랑 백제고분점,1,1,1,3
6228,s1066949838,1066949838,TheWave 롯데백화점본점,1,1,1,3
6229,s308063552,308063552,헤어여기로,1,1,1,3
6230,s20904120,20904120,예가헤어샵,1,1,1,3
6231,s1445361898,1445361898,101 BROW,1,1,1,3
6232,s11554841,11554841,전채영미용실,1,1,1,3
6233,s18034818,18034818,서지현미용실,1,1,1,3
6234,s617789589,617789589,나이스가이 위례로데오점,1,1,1,3
6235,s1378775405,1378775405,루아헤어앤스토어,1,1,1,3
6236,s18039459,18039459,두가헤어,1,1,1,3
6237,s1177138295,1177138295,TheWave 롯데백화점본점 F7,1,1,1,3
6238,s11590205,11590205,비쥬헤어,1,1,1,3
6239,s41082361,41082361,살롱오늘,1,1,1,3
6240,s1050909231,1050909231,한스헤어,1,1,1,3
6241,s34069484,34069484,헤어아쿠아,1,1,1,3
6242,s901023900,901023900,압구정헤어,1,1,1,3
6243,s37017934,37017934,봄 헤어  스튜디오,1,1,1,3
6244,s36701193,36701193,펠리아(가발) 롯데백화점본점,1,1,1,3
6245,s75848699,75848699,HAIR SHOP,1,1,1,3
6246,s523209793,523209793,블루천사,1,1,1,3
6247,sk1160118443,k1160118443,쁘띠헤어살롱,1,1,1,3
6248,s1106293210,1106293210,Js헤어샵,1,1,1,3
6249,s1993656885,1993656885,황제영 미용실,1,1,1,3
6250,s32990827,32990827,뿌띠보보잠실점,1,1,1,3
6251,s1947258267,1947258267,봄온헤어,1,1,1,3
6252,s1353847405,1353847405,처녀자리헤어,1,1,1,3
6253,s1281050779,1281050779,결헤어,1,1,1,3
6254,s36005279,36005279,우리들헤어,1,1,1,3
6255,s1594847524,1594847524,수헤어,1,1,1,3
6256,s1761952880,1761952880,놈,1,1,1,3
6257,s1137405000,1137405000,리오헤어 거여역점,1,1,1,3
6258,s18041105,18041105,우정미용실,1,1,1,3
6259,s1424576303,1424576303,샬롬헤어,1,1,1,3
6260,s1331800511,1331800511,모모헤어,1,1,1,3
6261,s1785548816,1785548816,원샵헤어,1,1,1,3
6262,s37374132,37374132,라인헤어,1,1,1,3
6263,s555136976,555136976,전지애헤어펀치,1,1,1,3
6264,s37769597,37769597,블레스헤어,1,1,1,3
6265,s1549699791,1549699791,어반헤어,1,1,1,3
6266,s37293885,37293885,헤어갤러리,1,1,1,3
6267,s1214967282,1214967282,신헤어,1,1,1,3
6268,s1314093834,1314093834,미작헤어,1,1,1,3
6269,s1581570087,1581570087,슈에뜨헤어,1,1,1,3
6270,s1723790784,1723790784,샬롬미용실,1,1,1,3
6271,s1082678566,1082678566,헤어랑스파,1,1,1,3
6272,s1457543022,1457543022,재인헤어샵,1,1,1,3
6273,s1529264791,1529264791,데일리헤어,1,1,1,3
6274,s1804512330,1804512330,헨조,1,1,1,3
6275,s1030172779,1030172779,이링헤어,1,1,1,3
6276,s18858970,18858970,주현헤어샵,1,1,1,3
6277,s1499154464,1499154464,아템홀렌,1,1,1,3
6278,s36728448,36728448,더웨이브 롯데백화점본점,1,1,1,3
6279,s1193598656,1193598656,25헤어,1,1,1,3
6280,s1342410740,1342410740,김민주네일,1,1,1,3
6281,s861788770,861788770,딸기머리,1,1,1,3
6282,s417954381,417954381,살롱드유,1,1,1,3
6283,s1470433739,1470433739,수컷,1,1,1,3
6284,s13151775,13151775,샤방헤어샵,1,1,1,3
6285,s987893583,987893583,샤방헤어샾,1,1,1,3
6286,s393970042,393970042,헤어샾 맑음,1,1,1,3
6287,s1132618709,1132618709,이민정헤어,1,1,1,3
6288,s960500254,960500254,하민헤어 방이점,1,1,1,3
6289,s1787517589,1787517589,염색공장,1,1,1,3
6290,s1262609228,1262609228,아이리스미용실,1,1,1,3
6291,s1729829015,1729829015,동주헤어,1,1,1,3
6292,s20841596,20841596,까끄레머리방,1,1,1,3
6293,s18436084,18436084,월드미용실,1,1,1,3
6294,s20891892,20891892,비키헤어스타,1,1,1,3
6295,s38752933,38752933,가위소리,1,1,1,3
6296,s20734806,20734806,선정헤어살롱,1,1,1,3
6297,s20914760,20914760,최수인헤어라인,1,1,1,3
6298,s1228946017,1228946017,아로미헤어샵,1,1,1,3
6299,s18810962,18810962,최미나헤어라인,1,1,1,3
6300,s20853186,20853186,서나미장,1,1,1,3
6301,s490870766,490870766,살롱드상파울루,1,1,1,3
6302,s20895484,20895484,유미미용실,1,1,1,3
6303,s18447304,18447304,토마토미용실,1,1,1,3
6304,s20929796,20929796,정수헤어라인,1,1,1,3
6305,s37935386,37935386,태양미용실,1,1,1,3
6306,s20853414,20853414,명동마샬미용실,1,1,1,3
6307,s1004861844,1004861844,머리여행준,1,1,1,3
6308,s1816237767,1816237767,샘미용실,1,1,1,3
6309,s20891837,20891837,임영빈헤어샵,1,1,1,3
6310,s1834523054,1834523054,이모머리방,1,1,1,3
6311,s18423236,18423236,펌앤컷,1,1,1,3
6312,s20857040,20857040,헤어커커스,1,1,1,3
6313,s1546837586,1546837586,선지영헤어컬링,1,1,1,3
6314,s18821117,18821117,은혜미용실,1,1,1,3
6315,s20918289,20918289,세희헤어아트,1,1,1,3
6316,s20856848,20856848,손경순미용실,1,1,1,3
6317,s20880266,20880266,박지수헤어월드,1,1,1,3
6318,s18825896,18825896,헤어캐슬,1,1,1,3
6319,s20899542,20899542,진미용실,1,1,1,3
6320,s1060033161,1060033161,이성자헤어샵,1,1,1,3
6321,s18434639,18434639,머리하는날,1,1,1,3
6322,s1067791185,1067791185,헤어스페이스,1,1,1,3
6323,s20891816,20891816,새마을미용실,1,1,1,3
6324,s20853241,20853241,임미용실,1,1,1,3
6325,s18422839,18422839,박지현헤어,1,1,1,3
6326,s20830094,20830094,나나미용실,1,1,1,3
6327,s18422836,18422836,하순도미용실,1,1,1,3
6328,s20922141,20922141,세븐미용실,1,1,1,3
6329,s1187787378,1187787378,은지헤어,1,1,1,3
6330,s20845508,20845508,연실헤어타운,1,1,1,3
6331,s20914576,20914576,은비,1,1,1,3
6332,s1185208337,1185208337,윤희미용실,1,1,1,3
6333,s1576934025,1576934025,미헤어샵,1,1,1,3
6334,s18417891,18417891,댕기머리크라시바헤어,1,1,1,3
6335,s18839437,18839437,머리하는날,1,1,1,3
6336,s20853418,20853418,태양미용실,1,1,1,3
6337,s1430222843,1430222843,꽃샘헤어,1,1,1,3
6338,s1018225920,1018225920,블루클럽 약수점,1,1,1,3
6339,s1948608225,1948608225,프리헤어,1,1,1,3
6340,s20872705,20872705,류미영헤어살롱,1,1,1,3
6341,s1678119874,1678119874,이소윤헤어플랜,1,1,1,3
6342,s18406954,18406954,ys헤어,1,1,1,3
6343,s20888129,20888129,박현옥헤어샵,1,1,1,3
6344,s1565860939,1565860939,아지트헤어,1,1,1,3
6345,s19419776,19419776,신세대미용실,1,1,1,3
6346,s12910904,12910904,1퍼센트헤어팀,1,1,1,3
6347,s19410529,19410529,멋뜰헤어,1,1,1,3
6348,s18421421,18421421,로로헤어,1,1,1,3
6349,s1036298019,1036298019,정혜선헤어샵,1,1,1,3
6350,s1662650826,1662650826,장미정헤어아트,1,1,1,3
6351,s20857022,20857022,헤어아트,1,1,1,3
6352,s18927581,18927581,이보미헤어,1,1,1,3
6353,s1919747468,1919747468,아르보떼,1,1,1,3
6354,s1830075632,1830075632,와이제이헤어살롱,1,1,1,3
6355,s1640126777,1640126777,레니오헤어,1,1,1,3
6356,s1109795272,1109795272,YJ헤어,1,1,1,3
6357,s20861005,20861005,블루클럽 등촌시장점,1,1,1,3
6358,s38753098,38753098,뮤즈헤어스페이스,1,1,1,3
6359,s1217612681,1217612681,신규헤어,1,1,1,3
6360,s21627157,21627157,머리꾼미용실,1,1,1,3
6361,s20926115,20926115,우리헤어라인,1,1,1,3
6362,s18434902,18434902,버르장머리,1,1,1,3
6363,s1914819981,1914819981,오즈헤어,1,1,1,3
6364,s20899511,20899511,이지선미용실,1,1,1,3
6365,s20902858,20902858,신정미래미용실,1,1,1,3
6366,s32056080,32056080,예쁜머리만들기,1,1,1,3
6367,s20899560,20899560,사랑의미용실,1,1,1,3
6368,s20861085,20861085,권미용실,1,1,1,3
6369,s18437805,18437805,새서울헤어클럽,1,1,1,3
6370,s20852927,20852927,란헤어아트,1,1,1,3
6371,s20884228,20884228,오즈미용실,1,1,1,3
6372,s18427791,18427791,김준오헤어스튜디오,1,1,1,3
6373,s18436729,18436729,우노미용실,1,1,1,3
6374,s20891685,20891685,태양미용실,1,1,1,3
6375,s20922071,20922071,초원헤어아트,1,1,1,3
6376,s20922116,20922116,신헤어터치,1,1,1,3
6377,s1568419427,1568419427,제일미용실,1,1,1,3
6378,s20914559,20914559,문미용실,1,1,1,3
6379,s18442761,18442761,순미용실,1,1,1,3
6380,s20868709,20868709,블루라인,1,1,1,3
6381,s1413128465,1413128465,봉쥬르헤어아트,1,1,1,3
6382,s18417895,18417895,최미진미용실,1,1,1,3
6383,s20821977,20821977,다미헤어목동1호점,1,1,1,3
6384,s20888897,20888897,하니미용실,1,1,1,3
6385,s1798844888,1798844888,미작헤어갤러리,1,1,1,3
6386,s1200603791,1200603791,아우라헤어,1,1,1,3
6387,s20872457,20872457,헤븐,1,1,1,3
6388,s1559714075,1559714075,스타일라뷰,1,1,1,3
6389,s1597572145,1597572145,카리스헤어,1,1,1,3
6390,s1372071685,1372071685,보나미용샵,1,1,1,3
6391,s1689737694,1689737694,로쉬헤어,1,1,1,3
6392,s19476823,19476823,신종호루키콥헤어살롱,1,1,1,3
6393,s18419916,18419916,수왕미용실,1,1,1,3
6394,s20918523,20918523,헤어스토리,1,1,1,3
6395,s1131634320,1131634320,제이원헤어,1,1,1,3
6396,s1124318742,1124318742,제일헤어,1,1,1,3
6397,s20821868,20821868,샴푸걸헤어,1,1,1,3
6398,s1166069576,1166069576,헤어스케치,1,1,1,3
6399,s20834857,20834857,터치헤어,1,1,1,3
6400,s12811691,12811691,서민호미용실2호점,1,1,1,3
6401,s18083419,18083419,블랙헤어,1,1,1,3
6402,s1266065073,1266065073,새로미미용실,1,1,1,3
6403,s20933292,20933292,연헤어라인,1,1,1,3
6404,s21043847,21043847,샤인헤어,1,1,1,3
6405,s20830058,20830058,넝쿨헤어방,1,1,1,3
6406,s20868800,20868800,맨스타헤어컬렉션,1,1,1,3
6407,s20857003,20857003,로즈헤어라인,1,1,1,3
6408,s18446114,18446114,엄지미용실,1,1,1,3
6409,s20845405,20845405,명진헤어,1,1,1,3
6410,s1514827114,1514827114,은경헤어라인,1,1,1,3
6411,s20821940,20821940,희미용실,1,1,1,3
6412,s1849570752,1849570752,화신미용실,1,1,1,3
6413,s18820321,18820321,규수방미용실,1,1,1,3
6414,s18075360,18075360,블루클럽 을지로3가점,1,1,1,3
6415,s11633842,11633842,S헤어,1,1,1,3
6416,s18042655,18042655,리라헤어라인,1,1,1,3
6417,s1011690659,1011690659,김경자헤어라인,1,1,1,3
6418,s20896725,20896725,컷팅클럽,1,1,1,3
6419,s18055120,18055120,엔젤미용실,1,1,1,3
6420,s1904270847,1904270847,은미헤어샵,1,1,1,3
6421,s20888047,20888047,현미용실,1,1,1,3
6422,s20937459,20937459,수경헤어살롱,1,1,1,3
6423,s1182516960,1182516960,윤희머리방,1,1,1,3
6424,s500576800,500576800,라푼젤헤어클럽,1,1,1,3
6425,s1538700932,1538700932,동그라미헤어,1,1,1,3
6426,s33481457,33481457,빅토리헤어,1,1,1,3
6427,s20821805,20821805,헤어매직미용실,1,1,1,3
6428,s20903079,20903079,J헤어커커,1,1,1,3
6429,s18839766,18839766,보람머리방,1,1,1,3
6430,s20910769,20910769,하영미용실,1,1,1,3
6431,s20906818,20906818,레인보우,1,1,1,3
6432,s1876248897,1876248897,미정헤어샵,1,1,1,3
6433,s1397716724,1397716724,나댐헤어,1,1,1,3
6434,s20910874,20910874,초원뷰티타운,1,1,1,3
6435,s20907186,20907186,샬롬미용실,1,1,1,3
6436,s18432627,18432627,정미용실,1,1,1,3
6437,s18835081,18835081,로얄미용실,1,1,1,3
6438,s20929781,20929781,까끌래뽀끌래,1,1,1,3
6439,s20887593,20887593,쥬노리미용실,1,1,1,3
6440,s271644631,271644631,새로나미용실,1,1,1,3
6441,s20903336,20903336,미주미용실,1,1,1,3
6442,s34883288,34883288,이철헤어커커 신월이마트점,1,1,1,3
6443,s1116729535,1116729535,이정헤어,1,1,1,3
6444,s35347141,35347141,로뎀나무헤어샵,1,1,1,3
6445,s20837924,20837924,윤희미용실,1,1,1,3
6446,s20880300,20880300,영뷰티샵,1,1,1,3
6447,s20876565,20876565,윤희미용실,1,1,1,3
6448,s1746006817,1746006817,이레미용실,1,1,1,3
6449,s18419919,18419919,와이미용실,1,1,1,3
6450,s1661807217,1661807217,헤어샵,1,1,1,3
6451,s20891872,20891872,태양헤어라인,1,1,1,3
6452,s20933707,20933707,머리털자리,1,1,1,3
6453,sk332725098,k332725098,무지개염색,1,1,1,3
6454,s20841554,20841554,다인미용실,1,1,1,3
6455,s18419899,18419899,왕자미용실,1,1,1,3
6456,s20822099,20822099,짱미용실,1,1,1,3
6457,s20830162,20830162,지숙헤어샵,1,1,1,3
6458,s20914515,20914515,예성미용실,1,1,1,3
6459,s20849568,20849568,은하미용실,1,1,1,3
6460,s20895433,20895433,센스미용실,1,1,1,3
6461,s18427795,18427795,미화미용실,1,1,1,3
6462,s20899545,20899545,국제미용실,1,1,1,3
6463,s844370709,844370709,홍미용실,1,1,1,3
6464,s37427481,37427481,헤어바이순정,1,1,1,3
6465,sk57491847,k57491847,황헤어샵,1,1,1,3
6466,s19390863,19390863,쎄씨벨,1,1,1,3
6467,s20644314,20644314,W헤어,1,1,1,3
6468,s18880938,18880938,헤어패밀리,1,1,1,3
6469,s34228037,34228037,블루클럽 송파한양점,1,1,1,3
6470,s18861167,18861167,러블리헤어,1,1,1,3
6471,s13501643,13501643,헤어리베미용실,1,1,1,3
6472,s18866927,18866927,유재국헤어,1,1,1,3
6473,s19972050,19972050,헤어플러스,1,1,1,3
6474,s1645855787,1645855787,미진헤어,1,1,1,3
6475,s578723569,578723569,김효리헤어,1,1,1,3
6476,s38349592,38349592,꾸밈헤어살롱,1,1,1,3
6477,s18883610,18883610,카미오금동점,1,1,1,3
6478,s20629199,20629199,준헤어,1,1,1,3
6479,s37003174,37003174,케이살롱,1,1,1,3
6480,s1431688375,1431688375,어반그라운드헤어 문정역점,1,1,1,3
6481,s20638766,20638766,M미장2호점,1,1,1,3
6482,s1491412177,1491412177,김재민헤어포레,1,1,1,3
6483,s18868726,18868726,써니헤어,1,1,1,3
6484,s20622969,20622969,예쁜머리,1,1,1,3
6485,s18879043,18879043,샤론헤어갤러리,1,1,1,3
6486,s20637074,20637074,파비앙뷰티헤어클럽,1,1,1,3
6487,s38742918,38742918,플레이스 제인,1,1,1,3
6488,s37309135,37309135,별하헤어,1,1,1,3
6489,s1512718269,1512718269,오땡큐풍납1동점,1,1,1,3
6490,s1215228735,1215228735,살롱드소리,1,1,1,3
6491,s1317373986,1317373986,조성희헤어갤러리,1,1,1,3
6492,s1560035349,1560035349,박정연헤어,1,1,1,3
6493,s18007683,18007683,블루헤어,1,1,1,3
6494,s1978533901,1978533901,LEE헤어,1,1,1,3
6495,s1498132031,1498132031,코코헤어,1,1,1,3
6496,s18869642,18869642,저스틴헤어,1,1,1,3
6497,s20902474,20902474,지희헤어,1,1,1,3
6498,s20629224,20629224,헤어스토리DO,1,1,1,3
6499,s31218124,31218124,씨엠헤어살롱,1,1,1,3
6500,s20860572,20860572,S헤어,1,1,1,3
6501,s18533446,18533446,비헤어,1,1,1,3
6502,s345933948,345933948,이지비아,1,1,1,3
6503,s1650462586,1650462586,수헤어,1,1,1,3
6504,s234730528,234730528,수헤어샵,1,1,1,3
6505,s20910109,20910109,오뜨헤어,1,1,1,3
6506,s1460161763,1460161763,라푼젤헤어샵,1,1,1,3
6507,s37756013,37756013,바움헤어2호점,1,1,1,3
6508,s18523603,18523603,나이스가이 가든파이브점,1,1,1,3
6509,s20879889,20879889,이정수헤어,1,1,1,3
6510,s1901663400,1901663400,장서윤헤어스튜디오,1,1,1,3
6511,s21056933,21056933,까까앤펌 풍납점,1,1,1,3
6512,s1675307809,1675307809,Mr cut,1,1,1,3
6513,s848693767,848693767,세아박헤어,1,1,1,3
6514,s20498879,20498879,서희미용실,1,1,1,3
6515,s1484033928,1484033928,헤어매직,1,1,1,3
6516,s13151781,13151781,세르띠,1,1,1,3
6517,s19776977,19776977,블링블링헤어,1,1,1,3
6518,s38279060,38279060,수려한헤어샵,1,1,1,3
6519,s38555761,38555761,엄지헤어,1,1,1,3
6520,s18871583,18871583,티움헤어,1,1,1,3
6521,s20622046,20622046,변가헤어아트,1,1,1,3
6522,s20940757,20940757,헤어코디,1,1,1,3
6523,s1871393817,1871393817,헤어포인트,1,1,1,3
6524,s1432772227,1432772227,목화미용실,1,1,1,3
6525,s38753096,38753096,엄지헤어샵,1,1,1,3
6526,s1134834959,1134834959,제이제이헤어,1,1,1,3
6527,s1364405346,1364405346,히즈모,1,1,1,3
6528,s20875739,20875739,문미용실,1,1,1,3
6529,s21656678,21656678,SPC헤어 송파점,1,1,1,3
6530,s1054515901,1054515901,쌍용헤어,1,1,1,3
6531,s20705015,20705015,헤어갤러리,1,1,1,3
6532,s1191813835,1191813835,김혜경헤어공간,1,1,1,3
6533,s19566454,19566454,신은영헤어,1,1,1,3
6534,s20644352,20644352,이은성헤어,1,1,1,3
6535,s20840966,20840966,원헤어,1,1,1,3
6536,s598772943,598772943,템테이션,1,1,1,3
6537,s34745324,34745324,헤어바이진,1,1,1,3
6538,s1768650356,1768650356,은주헤어,1,1,1,3
6539,s31502820,31502820,신시아미용실,1,1,1,3
6540,s18454976,18454976,박순애미용실,1,1,1,3
6541,s13151179,13151179,나래미용실,1,1,1,3
6542,s1891599301,1891599301,어서윤헤어,1,1,1,3
6543,s20494744,20494744,M Hair,1,1,1,3
6544,s20856539,20856539,이다헤어,1,1,1,3
6545,s35136189,35136189,헤어끌림,1,1,1,3
6546,s1531100324,1531100324,트루핏앤힐 바버샵 신라호텔점,1,1,1,3
6547,s20940758,20940758,헤어팡,1,1,1,3
6548,s1239672844,1239672844,HWASHOP,1,1,1,3
6549,s18091581,18091581,CNN헤어클럽,1,1,1,3
6550,s18869448,18869448,찰스헤어두 가락점,1,1,1,3
6551,s1990382019,1990382019,이레헤어,1,1,1,3
6552,s1920037191,1920037191,마네헤어샾,1,1,1,3
6553,s1815565126,1815565126,벧엘헤어샵,1,1,1,3
6554,s20929266,20929266,러블리헤어,1,1,1,3
6555,s18890676,18890676,선헤어라인,1,1,1,3
6556,s33625498,33625498,한헤어,1,1,1,3
6557,s20898807,20898807,황희수헤어드레서,1,1,1,3
6558,s18892157,18892157,김인옥헤어메이커,1,1,1,3
6559,s20852763,20852763,솔비헤어,1,1,1,3
6560,s20932953,20932953,뷰셀헤어,1,1,1,3
6561,s20936905,20936905,컷트클럽,1,1,1,3
6562,s20638531,20638531,H STYLE 헤어살롱 풍납점,1,1,1,3
6563,s11730141,11730141,블루클럽 문정점,1,1,1,3
6564,s20633091,20633091,연아헤어,1,1,1,3
6565,s20925271,20925271,정헤어샵,1,1,1,3
6566,s883787168,883787168,젠틀맨헤어,1,1,1,3
6567,s18871913,18871913,오정희미용실,1,1,1,3
6568,s1583006162,1583006162,쁘띠앙쥬헤어샵 가락1호점,1,1,1,3
6569,s1395778309,1395778309,스타일포유,1,1,1,3
6570,s31144154,31144154,지노헤어,1,1,1,3
6571,s614360961,614360961,아람헤어샵,1,1,1,3
6572,s35103524,35103524,S박헤어샵,1,1,1,3
6573,s1576589627,1576589627,로제헤어,1,1,1,3
6574,s11848029,11848029,펌앤펌헤어클리닉,1,1,1,3
6575,s35966636,35966636,짱헤어샵,1,1,1,3
6576,s20640979,20640979,금호헤어,1,1,1,3
6577,s1819719244,1819719244,정나라미용실,1,1,1,3
6578,s1351832570,1351832570,원스디자인,1,1,1,3
6579,s37338701,37338701,라온제나헤어 가락점,1,1,1,3
6580,s1198352017,1198352017,힐링미용실,1,1,1,3
6581,s1077100953,1077100953,나이스가이 가락점,1,1,1,3
6582,s1405484180,1405484180,더프로헤어,1,1,1,3
6583,s19997513,19997513,일프로 헤어클럽,1,1,1,3
6584,s13298065,13298065,헤라헤어,1,1,1,3
6585,s1674353219,1674353219,BOY&MAN,1,1,1,3
6586,s1072605320,1072605320,쉬즈헤어,1,1,1,3
6587,s19952240,19952240,개성연출미용실,1,1,1,3
6588,s20635550,20635550,현헤어,1,1,1,3
6589,s20910471,20910471,신원선헤어인,1,1,1,3
6590,s20644219,20644219,유하영헤어,1,1,1,3
6591,s1335728545,1335728545,헤어바이팔레트,1,1,1,3
6592,s18886889,18886889,에스헤어,1,1,1,3
6593,s20628635,20628635,헤어코코,1,1,1,3
6594,s1634825169,1634825169,마리헤어,1,1,1,3
6595,s1370529783,1370529783,신당점 케어셀라,1,1,1,3
6596,s724447912,724447912,민정헤어샾,1,1,1,3
6597,s20895002,20895002,이화헤어,1,1,1,3
6598,s20619721,20619721,윤헤어,1,1,1,3
6599,s20634109,20634109,미가헤어,1,1,1,3
6600,s1828854040,1828854040,에스헤어,1,1,1,3
6601,s13155328,13155328,깜장머리,1,1,1,3
6602,s18885155,18885155,지니헤어,1,1,1,3
6603,s18867514,18867514,김희경헤어갤러리,1,1,1,3
6604,s1620573309,1620573309,두바치헤어 본점,1,1,1,3
6605,s20825517,20825517,이지오헤어컷,1,1,1,3
6606,s20631579,20631579,크라크라헤어,1,1,1,3
6607,s1940829832,1940829832,천지헤어,1,1,1,3
6608,s1288206083,1288206083,레미니스헤어,1,1,1,3
6609,s1787211345,1787211345,예쁜손 가위손,1,1,1,3
6610,s18888979,18888979,헤어짱,1,1,1,3
6611,s1399692879,1399692879,김지효헤어,1,1,1,3
6612,s1036604379,1036604379,헤어준코,1,1,1,3
6613,s20849041,20849041,모닝헤어샵,1,1,1,3
6614,s1452567941,1452567941,헤어살롱 빛나,1,1,1,3
6615,s20902620,20902620,김양희미용실,1,1,1,3
6616,s20929314,20929314,다미헤어,1,1,1,3
6617,s20936706,20936706,제니아헤어,1,1,1,3
6618,s1753748688,1753748688,준헤어,1,1,1,3
6619,s20923210,20923210,h헤어,1,1,1,3
6620,s223029363,223029363,방가헤어스토리,1,1,1,3
6621,s19512323,19512323,예지머리향,1,1,1,3
6622,s37642536,37642536,러브김헤어,1,1,1,3
6623,s31549684,31549684,더레드헤어샵,1,1,1,3
6624,s1990798582,1990798582,아가페미용실,1,1,1,3
6625,s20633352,20633352,금은주헤어,1,1,1,3
6626,s475803136,475803136,수헤어샵,1,1,1,3
6627,s1828838400,1828838400,이해경헤어,1,1,1,3
6628,s20837142,20837142,라비헤어,1,1,1,3
6629,s20738759,20738759,라비쌍뜨헤어,1,1,1,3
6630,s13153091,13153091,307헤어,1,1,1,3
6631,s391308185,391308185,샬롬헤어,1,1,1,3
6632,s19952172,19952172,헤어스펠,1,1,1,3
6633,s18207685,18207685,이순희헤어,1,1,1,3
6634,s11660565,11660565,마샬미용실,1,1,1,3
6635,s20923149,20923149,에스헤어,1,1,1,3
6636,s12050096,12050096,Hair Salon The 예반,1,1,1,3
6637,s20638021,20638021,머리꾼,1,1,1,3
6638,s35559650,35559650,퀸즈헤나 약수점,1,1,1,3
6639,s36312519,36312519,추언탁헤어,1,1,1,3
6640,s20834892,20834892,LA헤어월드,1,1,1,3
6641,s31313055,31313055,은성미용실 신당지하쇼핑센터점,1,1,1,3
6642,s37879713,37879713,살롱드 니치 헤어,1,1,1,3
6643,s1495218194,1495218194,헤어블랙가든,1,1,1,3
6644,s1255716978,1255716978,그레이발소,1,1,1,3
6645,s1419944193,1419944193,이수목헤어스토리,1,1,1,3
6646,s18103334,18103334,개성시대,1,1,1,3
6647,s20846411,20846411,엠에스헤어,1,1,1,3
6648,s1526937497,1526937497,착한미용실,1,1,1,3
6649,s36721234,36721234,헤어풍경,1,1,1,3
6650,s1068092892,1068092892,새마을헤어샵,1,1,1,3
6651,s11694949,11694949,헤어야,1,1,1,3
6652,s36448994,36448994,THE공간,1,1,1,3
6653,s1331342207,1331342207,그레이헤어,1,1,1,3
6654,s36620370,36620370,씨엠헤어살롱,1,1,1,3
6655,s36547033,36547033,제이디헤어,1,1,1,3
6656,s1275732729,1275732729,5분헤어,1,1,1,3
6657,s20059156,20059156,앨리스헤어,1,1,1,3
6658,s13190090,13190090,스타일헤어,1,1,1,3
6659,s35896022,35896022,Han's 러브헤어,1,1,1,3
6660,s1086212928,1086212928,창훈이네 헤어,1,1,1,3
6661,s31475919,31475919,너네가찾던미용실,1,1,1,3
6662,s630108011,630108011,유진헤어,1,1,1,3
6663,s35500543,35500543,지니헤어,1,1,1,3
6664,s1061978358,1061978358,헤어톡스 바이 써니,1,1,1,3
6665,s1941796337,1941796337,헤어미미용실,1,1,1,3
6666,s18703025,18703025,새내기헤어클럽,1,1,1,3
6667,s20877530,20877530,리시헤어,1,1,1,3
6668,s36305130,36305130,민승희헤어,1,1,1,3
6669,s35840107,35840107,로뎀뷰티팜헤어,1,1,1,3
6670,s34762099,34762099,나인헤어 1호점,1,1,1,3
6671,s38321281,38321281,옥상달빛,1,1,1,3
6672,s208746654,208746654,롯드헤어,1,1,1,3
6673,s37549447,37549447,최수지헤어,1,1,1,3
6674,s34326013,34326013,Venus 헤어,1,1,1,3
6675,s31222344,31222344,보보미용실,1,1,1,3
6676,s21617032,21617032,보현헤어샵,1,1,1,3
6677,s21596471,21596471,오고파미용실,1,1,1,3
6678,s20830958,20830958,댕기머리,1,1,1,3
6679,s36663652,36663652,존앤스타일,1,1,1,3
6680,s41552274,41552274,수 헤어스튜디오,1,1,1,3
6681,s36860148,36860148,동명남성헤어,1,1,1,3
6682,s125033256,125033256,진희헤어,1,1,1,3
6683,s1107487930,1107487930,쁘띠미용실,1,1,1,3
6684,s20846507,20846507,플러스미헤어콜렉션,1,1,1,3
6685,s37765703,37765703,숲sok,1,1,1,3
6686,s1792811622,1792811622,단미,1,1,1,3
6687,s1328615635,1328615635,정윤화미용실,1,1,1,3
6688,s1388181771,1388181771,오땡큐 오금점,1,1,1,3
6689,s320650538,320650538,채연헤어,1,1,1,3
6690,s18495524,18495524,오픈헤어팀,1,1,1,3
6691,s18011757,18011757,롯데에스테틱살롱,1,1,1,3
6692,s623142587,623142587,헤어블링,1,1,1,3
6693,s1800556338,1800556338,헤어마니아,1,1,1,3
6694,s18041103,18041103,이감미용실,1,1,1,3
6695,s1348546223,1348546223,라비에벨뷰티샵,1,1,1,3
6696,s38431566,38431566,헤어26일오전,1,1,1,3
6697,s38502571,38502571,이쁘헤어,1,1,1,3
6698,s185478013,185478013,CIEL HAIR,1,1,1,3
6699,s38641769,38641769,라임헤어,1,1,1,3
6700,s20887435,20887435,스타일헤어,1,1,1,3
6701,s37588671,37588671,미장원by환영,1,1,1,3
6702,s18709029,18709029,미&미헤어신당점,1,1,1,3
6703,s18081809,18081809,고은미용실,1,1,1,3
6704,s1677605920,1677605920,보떼헤어,1,1,1,3
6705,s683500901,683500901,수현헤어,1,1,1,3
6706,s1717044753,1717044753,미남미녀 헤어샵,1,1,1,3
6707,s501013529,501013529,수니헤어,1,1,1,3
6708,s37170231,37170231,쌤아저씨미용실,1,1,1,3
6709,s1186084712,1186084712,아람헤어샾,1,1,1,3
6710,s1582326090,1582326090,지니헤어,1,1,1,3
6711,s18042659,18042659,이상미헤어작업실,1,1,1,3
6712,sk37261764,k37261764,미장원BY보배,1,1,1,3
6713,s37276613,37276613,애경헤어,1,1,1,3
6714,s18066891,18066891,이지현헤어샵,1,1,1,3
6715,s791113835,791113835,비타민헤어,1,1,1,3
6716,s37588660,37588660,토리헤어 거여역점,1,1,1,3
6717,s1918613891,1918613891,오땡큐 문정점,1,1,1,3
6718,s37439630,37439630,살롱제이,1,1,1,3
6719,s37459769,37459769,에스비헤어,1,1,1,3
6720,s364249992,364249992,블루클럽 위례중앙역점,1,1,1,3
6721,s37700585,37700585,헤어올리브,1,1,1,3
6722,s313294476,313294476,유진헤어모드,1,1,1,3
6723,s20634034,20634034,헤어컷문정점,1,1,1,3
6724,s1110508976,1110508976,남자다움,1,1,1,3
6725,s35984349,35984349,라벨르헤어,1,1,1,3
6726,s946709121,946709121,SM헤어,1,1,1,3
6727,s1280803025,1280803025,헤어수키,1,1,1,3
6728,s1257632169,1257632169,정윤헤어,1,1,1,3
6729,s31558706,31558706,루디아헤어,1,1,1,3
6730,s37500264,37500264,에이스헤어,1,1,1,3
6731,s1226761379,1226761379,졸리헤어,1,1,1,3
6732,s952788789,952788789,탐스헤어,1,1,1,3
6733,s1498934215,1498934215,까르페디엠,1,1,1,3
6734,s1445042304,1445042304,미스터컷,1,1,1,3
6735,s36444525,36444525,윤헤어,1,1,1,3
6736,s34267342,34267342,물결펌,1,1,1,3
6737,s1263312417,1263312417,용사부 헤어,1,1,1,3
6738,s13152784,13152784,쥬땜헤어갤러리,1,1,1,3
6739,s18885007,18885007,쥬뗌,1,1,1,3
6740,s716473172,716473172,보니헤어,1,1,1,3
6741,s1899715844,1899715844,살롱드이안,1,1,1,3
6742,s1140156074,1140156074,40-1,1,1,1,3
6743,s36285993,36285993,JHJ헤어살롱,1,1,1,3
6744,s796750814,796750814,꿈길머리방,1,1,1,3
6745,s36005276,36005276,은지헤어,1,1,1,3
6746,s37896399,37896399,요기헤어,1,1,1,3
6747,s1888094436,1888094436,살롱드봄,1,1,1,3
6748,s20632573,20632573,써니헤어,1,1,1,3
6749,s112484007,112484007,예가미장,1,1,1,3
6750,s19948190,19948190,하나헤어,1,1,1,3
6751,s1224970413,1224970413,미즈헤어,1,1,1,3
6752,s37816866,37816866,MY지샘미용실,1,1,1,3
6753,s1230614986,1230614986,끌레오미용실,1,1,1,3
6754,s31323417,31323417,제이엠헤어,1,1,1,3
6755,s1126195239,1126195239,이선영헤어,1,1,1,3
6756,s254567679,254567679,전혜영미용실,1,1,1,3
6757,s18891803,18891803,달님미용실,1,1,1,3
6758,s21795773,21795773,살롱드정범,1,1,1,3
6759,s20083702,20083702,오투피아,1,1,1,3
6760,s34354427,34354427,헤어팡,1,1,1,3
6761,s170790951,170790951,헤어가이,1,1,1,3
6762,s180451821,180451821,김혜정헤어아트,1,1,1,3
6763,s35444821,35444821,블루클럽 신천역점,1,1,1,3
6764,s34850225,34850225,리치헤어,1,1,1,3
6765,s33581052,33581052,봄헤어샵,1,1,1,3
6766,s33040168,33040168,킴스헤어,1,1,1,3
6767,s20636440,20636440,맨남성컷트,1,1,1,3
6768,s18108217,18108217,나이스가이 서소문점,1,1,1,3
6769,sk1820885982,k1820885982,라수아,1,1,1,3
6770,s1356972017,1356972017,레미디미용실,1,1,1,3
6771,s387868817,387868817,벨르,1,1,1,3
6772,s36504504,36504504,헤어바이제이티,1,1,1,3
6773,s33085369,33085369,리온헤어,1,1,1,3
6774,s18889869,18889869,굿모닝헤어아트,1,1,1,3
6775,s352789964,352789964,연헤어샵,1,1,1,3
6776,s38557661,38557661,나이스가이 거여점,1,1,1,3
6777,s1912548680,1912548680,더공감헤어,1,1,1,3
6778,s1637983068,1637983068,정필헤어맥스,1,1,1,3
6779,s35346738,35346738,무무헤어,1,1,1,3
6780,s34821508,34821508,고은헤어,1,1,1,3
6781,s502404125,502404125,이영미헤어,1,1,1,3
6782,s20449005,20449005,헤어갤러리,1,1,1,3
6783,s1126978381,1126978381,민들레미장 풍납점,1,1,1,3
6784,s35136345,35136345,A FLOOR,1,1,1,3
6785,s1753880156,1753880156,더끌림헤어살롱,1,1,1,3
6786,s20842943,20842943,루비오,1,1,1,3
6787,s546090738,546090738,유은정헤어,1,1,1,3
6788,s34354563,34354563,동우헤어,1,1,1,3
6789,s1799849221,1799849221,블링블링헤어,1,1,1,3
6790,s1420562132,1420562132,백경미용실,1,1,1,3
6791,s1197529631,1197529631,좋은인상헤어,1,1,1,3
6792,s1610281626,1610281626,현대미용실,1,1,1,3
6793,s38657174,38657174,쉔부른헤어살롱,1,1,1,3
6794,s18042651,18042651,신라미용실,1,1,1,3
6795,s34353771,34353771,파티오헤어,1,1,1,3
6796,s21857187,21857187,이룸헤어,1,1,1,3
6797,s518124391,518124391,민들레미용실,1,1,1,3
6798,s36166828,36166828,마르떼헤어,1,1,1,3
6799,s18887916,18887916,빗앤가위헤어샵,1,1,1,3
6800,s32289210,32289210,커너헤어,1,1,1,3
6801,s33292779,33292779,벨라뮤트헤어,1,1,1,3
6802,s33254029,33254029,레수에마니,1,1,1,3
6803,s35457364,35457364,나이스가이 레이크팰리스점,1,1,1,3
6804,s1545445358,1545445358,가락미용실,1,1,1,3
6805,s34458884,34458884,멋내드림미용실,1,1,1,3
6806,s1129445704,1129445704,미광헤어살롱,1,1,1,3
6807,s175348584,175348584,Seven Hair,1,1,1,3
6808,s20872568,20872568,RoRoHair,1,1,1,3
6809,s18440063,18440063,신트리미용실,1,1,1,3
6810,s20848066,20848066,세상의정상에서,1,1,1,3
6811,s1981889628,1981889628,타임플러스,1,1,1,3
6812,s1045858095,1045858095,민트헤어,1,1,1,3
6813,s1897393390,1897393390,예쁜당신헤어,1,1,1,3
6814,s1199310907,1199310907,더컷,1,1,1,3
6815,s18444771,18444771,헤어쵸이스,1,1,1,3
6816,s1327112813,1327112813,수헤어살롱,1,1,1,3
6817,s1772389169,1772389169,아모르헤어,1,1,1,3
6818,s1663117623,1663117623,남탕,1,1,1,3
6819,s1970383095,1970383095,헤어빈,1,1,1,3
6820,s1308515357,1308515357,봄날헤어,1,1,1,3
6821,s1104296046,1104296046,숏가위샵,1,1,1,3
6822,s1973557767,1973557767,쁘띠랑쥬헤어,1,1,1,3
6823,s1418745450,1418745450,아톰헤어,1,1,1,3
6824,s900230829,900230829,놀이터헤어,1,1,1,3
6825,s1872074607,1872074607,수헤어,1,1,1,3
6826,s1487159549,1487159549,조은염색,1,1,1,3
6827,s1148186031,1148186031,필헤어,1,1,1,3
6828,s1875044162,1875044162,스타일5.1,1,1,1,3
6829,s1707346352,1707346352,헤어스토리,1,1,1,3
6830,s1410733865,1410733865,그리심헤어,1,1,1,3
6831,s1082324540,1082324540,큐사랑S&A헤어,1,1,1,3
6832,s20641592,20641592,조인헤어,1,1,1,3
6833,s311885024,311885024,릴리프헤어&탈모두피관리센터,1,1,1,3
6834,s1102107683,1102107683,토리헤어 오목교점,1,1,1,3
6835,s1212503737,1212503737,리미용실,1,1,1,3
6836,s20873861,20873861,소라미용실,1,1,1,3
6837,s1992036320,1992036320,이미지헤어,1,1,1,3
6838,s35643819,35643819,bob  hair,1,1,1,3
6839,s18114612,18114612,모델미용실,1,1,1,3
6840,s20856693,20856693,칼리아헤어,1,1,1,3
6841,s36768441,36768441,제이오클락,1,1,1,3
6842,s36200291,36200291,180도헤어,1,1,1,3
6843,s1973790990,1973790990,오땡큐 목4동점,1,1,1,3
6844,s36005293,36005293,기성미용실,1,1,1,3
6845,s18437800,18437800,빨간머리앤미용실,1,1,1,3
6846,s18437802,18437802,황앤정머리하는곳,1,1,1,3
6847,s1647755803,1647755803,퀸&보스토탈헤어샵,1,1,1,3
6848,sk1981244625,k1981244625,주주헤어,1,1,1,3
6849,s1275107105,1275107105,잼잼헤어,1,1,1,3
6850,sk18091583,k18091583,현정미용실,1,1,1,3
6851,s20900367,20900367,현정미용실,1,1,1,3
6852,s1733077949,1733077949,오땡큐염색방,1,1,1,3
6853,s1037713668,1037713668,살롱드 라끄,1,1,1,3
6854,s1132959037,1132959037,에스헤어살롱,1,1,1,3
6855,s788088373,788088373,이훈헤어칼라신길1점,1,1,1,3
6856,s20877399,20877399,숙헤어리더,1,1,1,3
6857,s1654068517,1654068517,오로라미용실,1,1,1,3
6858,s20878941,20878941,초원헤어샵,1,1,1,3
6859,s1838357921,1838357921,화인미용실,1,1,1,3
6860,s32241089,32241089,예나미용실,1,1,1,3
6861,s31058993,31058993,마로헤어,1,1,1,3
6862,s1399678628,1399678628,헤어n,1,1,1,3
6863,s1030404337,1030404337,민수헤어,1,1,1,3
6864,s20924761,20924761,비녀헤어살롱,1,1,1,3
6865,s20863680,20863680,태후사랑 화곡1동점,1,1,1,3
6866,s11663573,11663573,박현주헤어클럽,1,1,1,3
6867,s1974738821,1974738821,이경민포레 명동점,1,1,1,3
6868,s13398042,13398042,피카소헤어존,1,1,1,3
6869,s1273906517,1273906517,월계미용실,1,1,1,3
6870,s1702015125,1702015125,박현희헤어,1,1,1,3
6871,s1471433478,1471433478,헤어바이이은,1,1,1,3
6872,s20890486,20890486,럭키헤어스테이션,1,1,1,3
6873,s20635904,20635904,이경은헤어스타일,1,1,1,3
6874,s36005288,36005288,전헤어샵,1,1,1,3
6875,s1580297067,1580297067,꽃담헤어,1,1,1,3
6876,s31395327,31395327,꾸미지오헤어샵,1,1,1,3
6877,s1563853302,1563853302,윤수희헤어스토리,1,1,1,3
6878,s1545184820,1545184820,진헤어,1,1,1,3
6879,s1519073984,1519073984,다온헤어,1,1,1,3
6880,s19409922,19409922,선영머리방,1,1,1,3
6881,s1206757436,1206757436,부부헤어살롱,1,1,1,3
6882,s1780011593,1780011593,SALON LUCKY,1,1,1,3
6883,s1757810234,1757810234,큐사랑 목동역점,1,1,1,3
6884,s1243573146,1243573146,나이스가이 신정이펜점,1,1,1,3
6885,s1956878291,1956878291,정헤어샵,1,1,1,3
6886,s1007908002,1007908002,Hee헤어뷰티,1,1,1,3
6887,s1360237753,1360237753,미소살롱,1,1,1,3
6888,s1501593138,1501593138,경동미용실,1,1,1,3
6889,s1587576440,1587576440,감동헤어,1,1,1,3
6890,s1059741177,1059741177,뷰티제시카,1,1,1,3
6891,s1508472206,1508472206,헬로우컷 목동점,1,1,1,3
6892,s20821978,20821978,더헤어신정점,1,1,1,3
6893,s1167145498,1167145498,윤헤어,1,1,1,3
6894,s1977304235,1977304235,the hair,1,1,1,3
6895,s1155274020,1155274020,JHair,1,1,1,3
6896,s11888604,11888604,Do헤어,1,1,1,3
6897,s219182379,219182379,salon de Eun,1,1,1,3
6898,s20899119,20899119,머리만들기,1,1,1,3
6899,s20857103,20857103,헤어캐슬,1,1,1,3
6900,s1405842775,1405842775,남자머리,1,1,1,3
6901,s36652131,36652131,JG트렌드헤어샾,1,1,1,3
6902,s20834092,20834092,민들레헤어샵,1,1,1,3
6903,s1844556296,1844556296,대화미용실,1,1,1,3
6904,s1211391733,1211391733,소담헤어,1,1,1,3
6905,s20838914,20838914,준헤어클럽,1,1,1,3
6906,s1432875466,1432875466,행복미용실,1,1,1,3
6907,s20860811,20860811,최윤희헤어,1,1,1,3
6908,s1454149286,1454149286,헤어트렌드,1,1,1,3
6909,s20822120,20822120,끌레오,1,1,1,3
6910,s1019675110,1019675110,더예쁜머리 신월점,1,1,1,3
6911,s20891671,20891671,채연앤헤어샵,1,1,1,3
6912,s20833799,20833799,샤이니헤어,1,1,1,3
6913,s1812647594,1812647594,빨강마녀미용실,1,1,1,3
6914,s20857211,20857211,머리바꿔,1,1,1,3
6915,sk1256264899,k1256264899,민주헤어샵,1,1,1,3
6916,s20822138,20822138,예쁜머리,1,1,1,3
6917,s38481544,38481544,소유헤어,1,1,1,3
6918,s1121146250,1121146250,약수이발관,1,1,1,3
6919,s37703649,37703649,미모안헤어,1,1,1,3
6920,s1200022723,1200022723,헤어스토리,1,1,1,3
6921,s1002731348,1002731348,도도헤어,1,1,1,3
6922,s20833956,20833956,정헤어클럽,1,1,1,3
6923,s18445298,18445298,인앤인헤어,1,1,1,3
6924,s1260069852,1260069852,헤어1004,1,1,1,3
6925,s1764397149,1764397149,체인지헤어,1,1,1,3
6926,s1403269490,1403269490,준미용실,1,1,1,3
6927,s354691087,354691087,도시여성,1,1,1,3
6928,s1013578741,1013578741,엘림헤어샵,1,1,1,3
6929,s20899449,20899449,김경숙헤어샵,1,1,1,3
6930,s19417370,19417370,강영애헤어샵,1,1,1,3
6931,s1538878434,1538878434,머리하기좋은날,1,1,1,3
6932,s1271872995,1271872995,하니샵,1,1,1,3
6933,s18427793,18427793,김성희헤어 본점,1,1,1,3
6934,s20929831,20929831,미장원바이린,1,1,1,3
6935,s1659261330,1659261330,머릿결사랑 신월1점,1,1,1,3
6936,s37064667,37064667,헤어8번가,1,1,1,3
6937,s1294884672,1294884672,승아헤어,1,1,1,3
6938,s20911612,20911612,송헤어,1,1,1,3
6939,s1875976531,1875976531,카라헤어,1,1,1,3
6940,s1778746289,1778746289,지우헤어샵,1,1,1,3
6941,s95088182,95088182,진헤어,1,1,1,3
6942,s952687485,952687485,밤 헤어,1,1,1,3
6943,s38514701,38514701,뮴헤어,1,1,1,3
6944,s18837516,18837516,아랑헤어 신월동본점,1,1,1,3
6945,s143218873,143218873,플레이샵,1,1,1,3
6946,s1296972223,1296972223,포레헤어,1,1,1,3
6947,s18120921,18120921,약수미용실,1,1,1,3
6948,s34349818,34349818,옥이네미장원,1,1,1,3
6949,s38734257,38734257,오땡큐,1,1,1,3
6950,s405087409,405087409,한채,1,1,1,3
6951,s20929916,20929916,헤어스케치,1,1,1,3
6952,s507520048,507520048,엘헤어,1,1,1,3
6953,s1737535144,1737535144,감성헤어살롱,1,1,1,3
6954,s34584939,34584939,브라운헤어,1,1,1,3
6955,s35873406,35873406,H헤어,1,1,1,3
6956,s1579082785,1579082785,토리헤어 약수역점,1,1,1,3
6957,s363193352,363193352,태후사랑 신정점,1,1,1,3
6958,s1506056833,1506056833,J헤어샾,1,1,1,3
6959,s1542837341,1542837341,세종헤어 목동점,1,1,1,3
6960,s34635403,34635403,Lee헤어,1,1,1,3
6961,s20892710,20892710,샵헤어,1,1,1,3
6962,s1150777133,1150777133,크라크라헤어,1,1,1,3
6963,s1389329866,1389329866,나이스가이 약수역점,1,1,1,3
6964,s1090275920,1090275920,플로라 헤어,1,1,1,3
6965,s1738011869,1738011869,수헤어모드,1,1,1,3
6966,s35203020,35203020,예랑컬,1,1,1,3
6967,s1195825366,1195825366,이지연헤어,1,1,1,3
6968,s1852072277,1852072277,민헤어,1,1,1,3
6969,s37929807,37929807,헤어베네,1,1,1,3
6970,s217693664,217693664,트레머리,1,1,1,3
6971,s1368772169,1368772169,강민수헤어샾,1,1,1,3
6972,s1268043182,1268043182,예준헤어샾,1,1,1,3
6973,s1525930920,1525930920,예준헤어샵,1,1,1,3
6974,s38252665,38252665,유키헤어,1,1,1,3
6975,s1082538580,1082538580,오션헤어,1,1,1,3
6976,s38454050,38454050,끌레르포유헤어살롱,1,1,1,3
6977,s1302856016,1302856016,살롱드구,1,1,1,3
6978,s1386933869,1386933869,헤어린,1,1,1,3
6979,s1052818697,1052818697,코코헤어샵,1,1,1,3
6980,s1169945927,1169945927,헤라헤어살롱,1,1,1,3
6981,s19013944,19013944,서울미장원,1,1,1,3
6982,s1605379246,1605379246,헤어가이,1,1,1,3
6983,s1272107275,1272107275,헤어투데이,1,1,1,3
6984,s20635999,20635999,조정숙미용실,1,1,1,3
6985,s1695894981,1695894981,에덴미용실,1,1,1,3
6986,s36005287,36005287,복지이발관,1,1,1,3
6987,s1562974879,1562974879,오땡큐 신길점,1,1,1,3
6988,s33605737,33605737,고현선헤어,1,1,1,3
6989,s20640704,20640704,은비미용실,1,1,1,3
6990,s20619437,20619437,수정미용실,1,1,1,3
6991,s33158164,33158164,김영헤어,1,1,1,3
6992,s1394479341,1394479341,수연미용실,1,1,1,3
6993,s18626358,18626358,로즈미용타운,1,1,1,3
6994,s20848444,20848444,임주영미용실,1,1,1,3
6995,s1015984591,1015984591,김수진미용실,1,1,1,3
6996,s20890961,20890961,공감헤어,1,1,1,3
6997,s20633770,20633770,블루클럽 신길역점,1,1,1,3
6998,s19011550,19011550,꽃도랑미용실,1,1,1,3
6999,s1421936214,1421936214,동네미용실,1,1,1,3
7000,s1484582646,1484582646,썬헤어샵,1,1,1,3
7001,s1613021089,1613021089,우리미용실,1,1,1,3
7002,s1798983359,1798983359,JS아트헤어,1,1,1,3
7003,s18676103,18676103,샤인헤어,1,1,1,3
7004,s1760433868,1760433868,까꼬뽀꼬미용실,1,1,1,3
7005,s20836580,20836580,샘미용실,1,1,1,3
7006,s37281246,37281246,아우라J헤어샵,1,1,1,3
7007,s18664722,18664722,조복순헤어아뜨리에,1,1,1,3
7008,s18673112,18673112,쎄븐미용실,1,1,1,3
7009,s20820523,20820523,가나헤어필,1,1,1,3
7010,s20620066,20620066,은하미용실,1,1,1,3
7011,s19003139,19003139,준미용실,1,1,1,3
7012,s20621788,20621788,파자미용타운,1,1,1,3
7013,s20855660,20855660,장미미용실,1,1,1,3
7014,s961989425,961989425,그림헤어,1,1,1,3
7015,s1176562503,1176562503,살롱엘에스,1,1,1,3
7016,s1093655118,1093655118,둘이랑헤어센스,1,1,1,3
7017,s38464071,38464071,헤어미,1,1,1,3
7018,s19014619,19014619,이현헤어샵,1,1,1,3
7019,s18649283,18649283,정정례헤어리더,1,1,1,3
7020,s1346870935,1346870935,한스미용실,1,1,1,3
7021,s1263474042,1263474042,이훈ALL30000 강북본점,1,1,1,3
7022,s1206439603,1206439603,알지요헤어샵,1,1,1,3
7023,s1277284380,1277284380,구은미헤어샵,1,1,1,3
7024,s17999485,17999485,2030헤어,1,1,1,3
7025,s1152820931,1152820931,쎄븐미용실,1,1,1,3
7026,s37203382,37203382,루치아 헤어살롱,1,1,1,3
7027,s1929308228,1929308228,명화헤어샵,1,1,1,3
7028,s1313720700,1313720700,백옥자헤어샾,1,1,1,3
7029,s1251622963,1251622963,스카이헤어샵,1,1,1,3
7030,s18667044,18667044,왕헤어아트,1,1,1,3
7031,s1369761019,1369761019,지혜미용실,1,1,1,3
7032,s1489460306,1489460306,정미용실,1,1,1,3
7033,s1047301999,1047301999,정헤어라인,1,1,1,3
7034,s13148316,13148316,와이헤어,1,1,1,3
7035,s1026875216,1026875216,정희미용실,1,1,1,3
7036,s13159670,13159670,엘리노헤어샾,1,1,1,3
7037,s20824588,20824588,와이헤어모드,1,1,1,3
7038,s1758459452,1758459452,아즈루헤어,1,1,1,3
7039,s30886716,30886716,헤어지엔,1,1,1,3
7040,s20820613,20820613,미&헤어,1,1,1,3
7041,s32113791,32113791,보라헤어,1,1,1,3
7042,s20875415,20875415,이소빈 머리나라,1,1,1,3
7043,s38704553,38704553,명륜머리방,1,1,1,3
7044,s20878896,20878896,송화미용실,1,1,1,3
7045,s1170559045,1170559045,평화미용실,1,1,1,3
7046,s1071786662,1071786662,정부서울청사미용실,1,1,1,3
7047,s20928474,20928474,개성시대,1,1,1,3
7048,s38507564,38507564,헤어사랑,1,1,1,3
7049,s20836280,20836280,나실미용실,1,1,1,3
7050,s20897892,20897892,보영미장원,1,1,1,3
7051,s20620038,20620038,돼지헤어리더,1,1,1,3
7052,s18651521,18651521,미미미용실,1,1,1,3
7053,s1838056125,1838056125,돼지미용실,1,1,1,3
7054,sk1291210693,k1291210693,로이드밤(신길역점),1,1,1,3
7055,s13159402,13159402,해바라기,1,1,1,3
7056,s20624832,20624832,사라미용실,1,1,1,3
7057,s20897939,20897939,사라미용실,1,1,1,3
7058,s1508122491,1508122491,사라헤어,1,1,1,3
7059,s11837842,11837842,사라헤어,1,1,1,3
7060,s1228597288,1228597288,원헤어,1,1,1,3
7061,s1453466628,1453466628,사라헤어샾,1,1,1,3
7062,s20828569,20828569,오스카미용실,1,1,1,3
7063,s20875506,20875506,에스더미용실,1,1,1,3
7064,s20624234,20624234,현헤어뷰티크,1,1,1,3
7065,s20913121,20913121,하니헤어라인,1,1,1,3
7066,s18583363,18583363,헤어파트너,1,1,1,3
7067,s1183056126,1183056126,성도미용실,1,1,1,3
7068,s20828541,20828541,유지영헤어샵,1,1,1,3
7069,s20621813,20621813,그놈헤어,1,1,1,3
7070,s20841278,20841278,최정헤어,1,1,1,3
7071,s20828539,20828539,한빛머리방,1,1,1,3
7072,s35966281,35966281,MASSIMO힐링헤어상봉점,1,1,1,3
7073,s13564080,13564080,퀸즈붙임머리,1,1,1,3
7074,s19010000,19010000,금화헤어샵,1,1,1,3
7075,s18651516,18651516,현대미용실,1,1,1,3
7076,s20874864,20874864,연옥미용타운,1,1,1,3
7077,s18597589,18597589,희망헤어샾,1,1,1,3
7078,s1052127362,1052127362,음악헤어모드,1,1,1,3
7079,s20638260,20638260,이선영헤어샵,1,1,1,3
7080,s1323866717,1323866717,인기미용타운,1,1,1,3
7081,s13160028,13160028,오사례헤어살롱,1,1,1,3
7082,s657776887,657776887,마르떼헤어,1,1,1,3
7083,s1181994111,1181994111,CM헤어살롱,1,1,1,3
7084,s1557037476,1557037476,Hair salon 그리다,1,1,1,3
7085,s539326750,539326750,제니스미용실,1,1,1,3
7086,s20632185,20632185,사랑헤어,1,1,1,3
7087,s1169851269,1169851269,에벤에셀헤어샵,1,1,1,3
7088,s1418428917,1418428917,앨리스헤어,1,1,1,3
7089,s1452589552,1452589552,민헤어스케치,1,1,1,3
7090,s19018695,19018695,정애헤어모드,1,1,1,3
7091,s1298442885,1298442885,아카시아미용실,1,1,1,3
7092,s18583349,18583349,드보라미용실,1,1,1,3
7093,s1007706513,1007706513,서촌머리방박동광씨,1,1,1,3
7094,s1744040569,1744040569,오헤어2000,1,1,1,3
7095,s1178284406,1178284406,까까쟁이미용실,1,1,1,3
7096,s1860369369,1860369369,난아헤어,1,1,1,3
7097,s13150881,13150881,서희헤어샵,1,1,1,3
7098,s18651527,18651527,조이미용실,1,1,1,3
7099,s20620285,20620285,임마누엘미용실,1,1,1,3
7100,s1112250928,1112250928,올리브헤어,1,1,1,3
7101,s20625869,20625869,김선례헤어샵,1,1,1,3
7102,s1887951998,1887951998,팽귄미용실,1,1,1,3
7103,s20636825,20636825,삼풍미용실,1,1,1,3
7104,s1668069347,1668069347,장성헤어,1,1,1,3
7105,s20844091,20844091,아람미용실,1,1,1,3
7106,s1569968519,1569968519,은혜미용실,1,1,1,3
7107,s854902128,854902128,원스헤어,1,1,1,3
7108,s20909517,20909517,은혜헤어이벤트,1,1,1,3
7109,s1294521941,1294521941,진영헤어센스,1,1,1,3
7110,s20874963,20874963,래미안헤어샵,1,1,1,3
7111,s20913078,20913078,배넷머리,1,1,1,3
7112,s33284284,33284284,구피샵 대림점,1,1,1,3
7113,s32114065,32114065,은혜미용실,1,1,1,3
7114,s1201109878,1201109878,미헤어클럽,1,1,1,3
7115,s20924599,20924599,필헤어아트,1,1,1,3
7116,s20828537,20828537,화이트헤어,1,1,1,3
7117,s1149603511,1149603511,미나라,1,1,1,3
7118,s20859611,20859611,진주미용실,1,1,1,3
7119,s1250791967,1250791967,금동자헤어,1,1,1,3
7120,s20828588,20828588,뀌띠리브뷰티살롱대림점,1,1,1,3
7121,s1118179334,1118179334,미향헤어샵,1,1,1,3
7122,s866015653,866015653,JIGA HAIR,1,1,1,3
7123,s1458716405,1458716405,헤어카페,1,1,1,3
7124,s1537483288,1537483288,대림미용실,1,1,1,3
7125,s1751721183,1751721183,심미미용실,1,1,1,3
7126,s19016861,19016861,아미가미용실,1,1,1,3
7127,s383640991,383640991,태후사랑 평창동점,1,1,1,3
7128,s19016035,19016035,글라라헤어아트,1,1,1,3
7129,s1183030201,1183030201,헤어클럽,1,1,1,3
7130,s37798066,37798066,라라에르모슈라,1,1,1,3
7131,s19017751,19017751,류나영헤어스토리,1,1,1,3
7132,s20620950,20620950,신동아미용실,1,1,1,3
7133,s1175438289,1175438289,818헤어살롱,1,1,1,3
7134,s1153737059,1153737059,이노헤어,1,1,1,3
7135,s19011005,19011005,버르장머리헤어,1,1,1,3
7136,s20939837,20939837,혜은헤어,1,1,1,3
7137,s1810654961,1810654961,한신미용실,1,1,1,3
7138,s1074833674,1074833674,그린헤어아트,1,1,1,3
7139,s1920250205,1920250205,조서인헤어,1,1,1,3
7140,s20836461,20836461,수연헤어,1,1,1,3
7141,s1280818346,1280818346,한일헤어샵,1,1,1,3
7142,s20824632,20824632,미즈미용실,1,1,1,3
7143,s20627398,20627398,하지운헤어아트,1,1,1,3
7144,s1390323073,1390323073,자연미용실,1,1,1,3
7145,s1269536171,1269536171,댕기머리,1,1,1,3
7146,s1892460261,1892460261,제일미헤어,1,1,1,3
7147,s1154786317,1154786317,윤희헤어샵,1,1,1,3
7148,s19013269,19013269,힐링헤어신길점,1,1,1,3
7149,s19016765,19016765,헤어코디헤어샵,1,1,1,3
7150,s1487974133,1487974133,수헤어케미,1,1,1,3
7151,s1715037517,1715037517,한나경헤어머리향기,1,1,1,3
7152,s20939716,20939716,나혜정헤어나라,1,1,1,3
7153,s1533772162,1533772162,모노헤어,1,1,1,3
7154,s1636603077,1636603077,살롱드씨엘,1,1,1,3
7155,s20889024,20889024,머리짱,1,1,1,3
7156,s1025948914,1025948914,헤어콜렉션,1,1,1,3
7157,s20888085,20888085,맨투맨신월점,1,1,1,3
7158,s19410199,19410199,보고머리,1,1,1,3
7159,s11852509,11852509,김승진헤어비스,1,1,1,3
7160,s20906941,20906941,현미용실,1,1,1,3
7161,s18422405,18422405,매직헤어칼라,1,1,1,3
7162,s18440071,18440071,예은헤어스토리,1,1,1,3
7163,s20382151,20382151,유동희프로헤어,1,1,1,3
7164,s1001437725,1001437725,수정헤어,1,1,1,3
7165,s32059224,32059224,헤스티아헤어2호점,1,1,1,3
7166,s19416632,19416632,신화미용실,1,1,1,3
7167,s1894809262,1894809262,까리노헤어,1,1,1,3
7168,s18440067,18440067,도원미용실,1,1,1,3
7169,s20907038,20907038,코코헤어,1,1,1,3
7170,s20548758,20548758,김나연헤어아트,1,1,1,3
7171,s20821656,20821656,김희진미용실,1,1,1,3
7172,s20925905,20925905,박지혜헤어,1,1,1,3
7173,s33385416,33385416,권홍패밀리헤어 신정점,1,1,1,3
7174,s18835480,18835480,백합미용실,1,1,1,3
7175,s20857200,20857200,수헤어아트,1,1,1,3
7176,s18702891,18702891,김영프로헤어,1,1,1,3
7177,s36005285,36005285,스타머리방,1,1,1,3
7178,s38004084,38004084,더헤어꾸니,1,1,1,3
7179,s1841673758,1841673758,여나목헤어,1,1,1,3
7180,s19981802,19981802,리본헤어,1,1,1,3
7181,s18708053,18708053,고운헤어샵,1,1,1,3
7182,s21900793,21900793,나비바이헤어뉴스,1,1,1,3
7183,s18256809,18256809,헤어아트,1,1,1,3
7184,s36005283,36005283,머리못하는집 목동 142호점,1,1,1,3
7185,s11728812,11728812,나이스가이 목동파리공원점,1,1,1,3
7186,s38419742,38419742,장루이다비드 목동 디자이너작품,1,1,1,3
7187,s1009219373,1009219373,수지헤어샵,1,1,1,3
7188,s36090792,36090792,서연우미용실,1,1,1,3
7189,s11728342,11728342,르시엘블루헤어목동점,1,1,1,3
7190,s1090912132,1090912132,헤어샵미,1,1,1,3
7191,s18400960,18400960,권미화미용실,1,1,1,3
7192,s20910930,20910930,희미용실,1,1,1,3
7193,s1006172953,1006172953,훼더미용실,1,1,1,3
7194,s36266872,36266872,앤젤라헤어,1,1,1,3
7195,s20880407,20880407,김민주헤어크리닉,1,1,1,3
7196,s20860714,20860714,웨이브스미용실,1,1,1,3
7197,s20914491,20914491,리즈헤어빌,1,1,1,3
7198,s18091567,18091567,고현옥뷰티센터,1,1,1,3
7199,s19418987,19418987,썬미용타운,1,1,1,3
7200,s20877680,20877680,칼라미용실,1,1,1,3
7201,s1503759703,1503759703,BL헤어,1,1,1,3
7202,s1576815612,1576815612,가빈미용실,1,1,1,3
7203,s18422853,18422853,에덴미용실,1,1,1,3
7204,s1689274426,1689274426,마르떼헤어,1,1,1,3
7205,s20830161,20830161,헤어디자인,1,1,1,3
7206,s19413209,19413209,유진헤어샵,1,1,1,3
7207,s1382291056,1382291056,살롱드봄,1,1,1,3
7208,s18406309,18406309,BOB헤어,1,1,1,3
7209,s1895833663,1895833663,N미용실,1,1,1,3
7210,s19419388,19419388,로웰헤어,1,1,1,3
7211,s18708203,18708203,현경헤어월드,1,1,1,3
7212,s1163353756,1163353756,강경애헤어,1,1,1,3
7213,s20825656,20825656,쏘니아헤어갤러리,1,1,1,3
7214,s1683473915,1683473915,헤어오브네이쳐 신당점,1,1,1,3
7215,s20930023,20930023,아름다운머리방,1,1,1,3
7216,s11730360,11730360,블루클럽 신당6동점,1,1,1,3
7217,s18437862,18437862,로라뷰티헤어,1,1,1,3
7218,s20914557,20914557,조미란미용실,1,1,1,3
7219,s20608202,20608202,머리쟁이,1,1,1,3
7220,s20880335,20880335,세진미용실,1,1,1,3
7221,s1384252820,1384252820,헤어갤러리,1,1,1,3
7222,s1163450743,1163450743,헤어뱅뱅미용실,1,1,1,3
7223,s13158212,13158212,뮤헤어,1,1,1,3
7224,s137335265,137335265,요술머리,1,1,1,3
7225,s20862353,20862353,이스헤어,1,1,1,3
7226,s20827002,20827002,허리케인헤어,1,1,1,3
7227,s20888866,20888866,명동헤어샵,1,1,1,3
7228,s11730188,11730188,블루클럽 목동역점,1,1,1,3
7229,s20883961,20883961,보카헤어,1,1,1,3
7230,s20826026,20826026,파마온 신월본점,1,1,1,3
7231,s20925881,20925881,꾸미오헤어샵신월점,1,1,1,3
7232,s131005811,131005811,헤어코코,1,1,1,3
7233,s18703487,18703487,시연머리방,1,1,1,3
7234,s20918364,20918364,코코헤어샵,1,1,1,3
7235,s20864790,20864790,제이헤어샵,1,1,1,3
7236,s35386810,35386810,마카리조헤어,1,1,1,3
7237,s1337460537,1337460537,가림헤어,1,1,1,3
7238,s11730222,11730222,블루클럽 신정푸른마을점,1,1,1,3
7239,s35032198,35032198,미헤어메이드,1,1,1,3
7240,s20929937,20929937,오렌지헤어샵,1,1,1,3
7241,s1602529086,1602529086,헤어스케치,1,1,1,3
7242,s20881670,20881670,굿투굿헤어,1,1,1,3
7243,s18422972,18422972,명문헤어샵,1,1,1,3
7244,s20884364,20884364,이가김가미용실,1,1,1,3
7245,s37487032,37487032,이은지헤어스튜디오,1,1,1,3
7246,s70485455,70485455,헤어보보,1,1,1,3
7247,s1266860368,1266860368,나이스가이 신정점,1,1,1,3
7248,s18446091,18446091,타워미용실,1,1,1,3
7249,s1636162601,1636162601,윤미희헤어클럽,1,1,1,3
7250,s1777715375,1777715375,아리솔헤어샾,1,1,1,3
7251,s53977236,53977236,배복심헤어크리닉,1,1,1,3
7252,s20926008,20926008,목동미용실,1,1,1,3
7253,s13347418,13347418,엘로임뷰티헤어,1,1,1,3
7254,s20739298,20739298,예림헤어샵,1,1,1,3
7255,s37803357,37803357,salon s,1,1,1,3
7256,sk1454866953,k1454866953,래미안헤어,1,1,1,3
7257,s20925983,20925983,미뷰티헤어,1,1,1,3
7258,s20914537,20914537,가위손,1,1,1,3
7259,s36196210,36196210,이봄헤어,1,1,1,3
7260,s1982344512,1982344512,쎄씨헤어샵,1,1,1,3
7261,s20856734,20856734,머리하는풍경,1,1,1,3
7262,s19406970,19406970,단발령,1,1,1,3
7263,s1031141011,1031141011,미미용실,1,1,1,3
7264,s1565611413,1565611413,필드미용실,1,1,1,3
7265,s20853367,20853367,스마일헤어광장,1,1,1,3
7266,s18440058,18440058,꾸미지오헤어샵,1,1,1,3
7267,s11717184,11717184,조성기헤어젯,1,1,1,3
7268,s1689589455,1689589455,문화이용원,1,1,1,3
7269,s1580861411,1580861411,헤어피플 신트리점,1,1,1,3
7270,s31248808,31248808,샬롬헤어숍,1,1,1,3
7271,s20856914,20856914,잔디헤어아트,1,1,1,3
7272,s20857195,20857195,수미현미용실,1,1,1,3
7273,s18434636,18434636,헤어창고,1,1,1,3
7274,s36812432,36812432,알레이샤론헤어,1,1,1,3
7275,s20903148,20903148,멋모아헤어샵,1,1,1,3
7276,s1068349160,1068349160,머리사랑,1,1,1,3
7277,s171055736,171055736,미랑컬미용실,1,1,1,3
7278,s1130081745,1130081745,미랑컬헤어,1,1,1,3
7279,s20936991,20936991,밀레니엄헤어필,1,1,1,3
7280,s20821703,20821703,헤어클럽,1,1,1,3
7281,s20899217,20899217,포근헤어뱅크,1,1,1,3
7282,s37826262,37826262,머리하는날,1,1,1,3
7283,s1200276993,1200276993,뽀끌레헤어토크,1,1,1,3
7284,s18704368,18704368,가위손,1,1,1,3
7285,s18121772,18121772,주헤어뱅크,1,1,1,3
7286,s18426929,18426929,노랑머리,1,1,1,3
7287,s20827077,20827077,소희미용실,1,1,1,3
7288,s1522466527,1522466527,제이헤어샾,1,1,1,3
7289,s32618523,32618523,앨리스헤어,1,1,1,3
7290,s1716701496,1716701496,쎄븐헤어,1,1,1,3
7291,s18431102,18431102,선헤어라인,1,1,1,3
7292,sk21685962,k21685962,준미용실,1,1,1,3
7293,s19410325,19410325,미래헤어샵,1,1,1,3
7294,s18708410,18708410,김수연헤어샵,1,1,1,3
7295,s18090784,18090784,헤어파트너,1,1,1,3
7296,s20930028,20930028,멋쟁이헤어신정3호점,1,1,1,3
7297,s20837909,20837909,까까머리방,1,1,1,3
7298,s1014127270,1014127270,화이트미용실,1,1,1,3
7299,s1341525186,1341525186,고현정헤어스토리,1,1,1,3
7300,s11671877,11671877,나이스가이 목동점,1,1,1,3
7301,s20937186,20937186,헤어스케치,1,1,1,3
7302,s20907036,20907036,헤어62,1,1,1,3
7303,s20896799,20896799,박헤어클럽,1,1,1,3
7304,s18423295,18423295,엔젤미용실,1,1,1,3
7305,s20880375,20880375,그리심미용실,1,1,1,3
7306,s1554905293,1554905293,머리하는집,1,1,1,3
7307,s1212438239,1212438239,다은미용실,1,1,1,3
7308,s1789633054,1789633054,펌앤컷헤어숍,1,1,1,3
7309,s1646412178,1646412178,펌&컷헤어샵,1,1,1,3
7310,s20827169,20827169,샤론헤어샵,1,1,1,3
7311,s18444763,18444763,황명후헤어갤러리,1,1,1,3
7312,s36454707,36454707,블롱헤어,1,1,1,3
7313,s38781526,38781526,이훈ALL30000,1,1,1,3
7314,s1774305835,1774305835,보현미용실,1,1,1,3
7315,s11835693,11835693,리헤어프렌즈,1,1,1,3
7316,s1559956237,1559956237,에스헤어갤러리,1,1,1,3
7317,s1472077932,1472077932,이지헤어,1,1,1,3
7318,s1635954378,1635954378,이현정헤어,1,1,1,3
7319,s20849523,20849523,진주머리방,1,1,1,3
7320,s588892205,588892205,Men s Hair,1,1,1,3
7321,s20849460,20849460,박현주헤어체인지,1,1,1,3
7322,s1982213227,1982213227,제일이용실,1,1,1,3
7323,s21052435,21052435,드림&헤어,1,1,1,3
7324,s18839395,18839395,미헤어아트,1,1,1,3
7325,s1292735620,1292735620,헤어클럽,1,1,1,3
7326,s1885373975,1885373975,샤넬헤어,1,1,1,3
7327,s20937462,20937462,크로스헤어,1,1,1,3
7328,s1308574886,1308574886,러블리헤어,1,1,1,3
7329,s1953930217,1953930217,살롱드이든,1,1,1,3
7330,s1574276905,1574276905,채미미용실,1,1,1,3
7331,s20877434,20877434,밀레니엄헤어,1,1,1,3
7332,s1811993170,1811993170,미니멀헤어,1,1,1,3
7333,s20876324,20876324,까끌래깍자,1,1,1,3
7334,s1824829670,1824829670,개성시대,1,1,1,3
7335,s20872604,20872604,가위와빗,1,1,1,3
7336,s1094257186,1094257186,김정아헤어,1,1,1,3
7337,s21089611,21089611,아인헤어,1,1,1,3
7338,s1072325778,1072325778,라벨르헤어,1,1,1,3
7339,s1910311850,1910311850,제이헤어,1,1,1,3
7340,s1219137354,1219137354,밀래말래,1,1,1,3
7341,s36669454,36669454,파비앙헤어,1,1,1,3
7342,s1688043794,1688043794,머리못하는집,1,1,1,3
7343,s1156328741,1156328741,하루헤어,1,1,1,3
7344,s1872086214,1872086214,청담미용실,1,1,1,3
7345,s1193814659,1193814659,기분좋은날헤어,1,1,1,3
7346,s1698157315,1698157315,수미장원,1,1,1,3
7347,s1772463210,1772463210,헤어살롱라벨르,1,1,1,3
7348,s34043991,34043991,스타일 바이스토리,1,1,1,3
7349,s20910872,20910872,수헤어아트,1,1,1,3
7350,s1081984733,1081984733,혜림헤어,1,1,1,3
7351,s20885335,20885335,나토얀미용실,1,1,1,3
7352,s1017647332,1017647332,향기헤어,1,1,1,3
7353,s18446104,18446104,엘린헤어,1,1,1,3
7354,s1256280267,1256280267,유정헤어샵,1,1,1,3
7355,s34348559,34348559,레몬트리미용실,1,1,1,3
7356,s1170580997,1170580997,차밍헤어,1,1,1,3
7357,s1697039093,1697039093,라벨르헤어 2호점,1,1,1,3
7358,s1294374897,1294374897,헤어염색카페 신월점,1,1,1,3
7359,s1223934768,1223934768,아름다운헤어살롱,1,1,1,3
7360,s1482984546,1482984546,미인만들기헤어샵,1,1,1,3
7361,s1073740076,1073740076,더문미용실,1,1,1,3
7362,s1308586032,1308586032,청담헤어 신월동점,1,1,1,3
7363,s1129935615,1129935615,홍연헤어,1,1,1,3
7364,s19826583,19826583,머리사랑,1,1,1,3
7365,s1069002529,1069002529,김말숙헤어샵,1,1,1,3
7366,s20925727,20925727,공간미용실신월본점,1,1,1,3
7367,s1286673835,1286673835,김선민헤어포인트,1,1,1,3
7368,s1315269792,1315269792,헤어지지마,1,1,1,3
7369,s20841589,20841589,빈스헤어키키,1,1,1,3
7370,s1863685809,1863685809,아름다운사람들,1,1,1,3
7371,s1807170130,1807170130,태후사랑 목5동점,1,1,1,3
7372,s33851024,33851024,사브라헤어,1,1,1,3
7373,s36336954,36336954,헤어에비뉴,1,1,1,3
7374,s36276395,36276395,쉬작헤어,1,1,1,3
7375,s20876104,20876104,헤어스케치,1,1,1,3
7376,s82454039,82454039,오샤론헤어,1,1,1,3
7377,s1428675750,1428675750,타로헤어스튜디오,1,1,1,3
7378,s18440060,18440060,정성숙머리만들기,1,1,1,3
7379,s37302376,37302376,이훈헤어칼라 목동점,1,1,1,3
7380,s1008837118,1008837118,CL헤어파트너,1,1,1,3
7381,s1469029670,1469029670,어반스타일,1,1,1,3
7382,s1037765403,1037765403,파크에비뉴,1,1,1,3
7383,s36763837,36763837,안나헤어스토리,1,1,1,3
7384,s36286037,36286037,살롱드 아르보,1,1,1,3
7385,s36722312,36722312,이훈ALL30000,1,1,1,3
7386,s36406694,36406694,헤어리더,1,1,1,3
7387,s21068708,21068708,강수정BY헤어필,1,1,1,3
7388,s36480981,36480981,제니헤어,1,1,1,3
7389,s1928301273,1928301273,상상헤어샵,1,1,1,3
7390,s36547424,36547424,즐거운상상헤어,1,1,1,3
7391,s1341578257,1341578257,마호,1,1,1,3
7392,s38557653,38557653,이훈ALL30000 신정점,1,1,1,3
7393,s1882859902,1882859902,가위든깍세,1,1,1,3
7394,s1230695696,1230695696,레드헤어쿨 목동점,1,1,1,3
7395,s1108941254,1108941254,룰미용실,1,1,1,3
7396,s1614449184,1614449184,선미용실,1,1,1,3
7397,s1391834499,1391834499,제이뷰몬드헤어,1,1,1,3
7398,s37452923,37452923,토리헤어 목동점,1,1,1,3
7399,s13139594,13139594,헤어리즘,1,1,1,3
7400,s1426833017,1426833017,올리브헤어,1,1,1,3
7401,s1057317895,1057317895,시온헤어,1,1,1,3
7402,s34795794,34795794,라온헤어,1,1,1,3
7403,s32816815,32816815,J헤어,1,1,1,3
7404,s1094506123,1094506123,머리여행,1,1,1,3
7405,s1939023425,1939023425,헤어케미,1,1,1,3
7406,s37089763,37089763,블랙민트헤어,1,1,1,3
7407,s35085140,35085140,헤어미모,1,1,1,3
7408,s34350273,34350273,헤일로헤어,1,1,1,3
7409,s36263554,36263554,유니스,1,1,1,3
7410,s20826205,20826205,헤어패밀리,1,1,1,3
7411,s35444719,35444719,홍헤어,1,1,1,3
7412,s35489367,35489367,애라벨르헤어숍,1,1,1,3
7413,s31212985,31212985,달달한미용실,1,1,1,3
7414,s1238065966,1238065966,보니앤클라이드 신정네거리역점,1,1,1,3
7415,s1919561013,1919561013,헤어포레,1,1,1,3
7416,s36670248,36670248,헤어바이오즈,1,1,1,3
7417,s206616576,206616576,류가헤어,1,1,1,3
7418,s20891714,20891714,미헤어,1,1,1,3
7419,s1457312309,1457312309,헤어카스테라살롱,1,1,1,3
7420,s11688658,11688658,미스터 카우보이,1,1,1,3
7421,s20326829,20326829,오라클헤어,1,1,1,3
7422,s35581327,35581327,프로방스헤어,1,1,1,3
7423,s1366284605,1366284605,힐링헤어,1,1,1,3
7424,s20895108,20895108,미코헤어,1,1,1,3
7425,s20929802,20929802,머리이야기,1,1,1,3
7426,s20880530,20880530,미헤어사랑,1,1,1,3
7427,s850695515,850695515,샤인헤어살롱,1,1,1,3
7428,s36005284,36005284,타임플러스신월뉴타운점,1,1,1,3
7429,s35906249,35906249,황지원스텔라헤어,1,1,1,3
7430,s20914716,20914716,써니헤어,1,1,1,3
7431,s20826134,20826134,컷헤어,1,1,1,3
7432,s32390129,32390129,뷰티초이스,1,1,1,3
7433,s18843266,18843266,지우미용실신월점,1,1,1,3
7434,s20937084,20937084,샬롬헤어샵,1,1,1,3
7435,s38704424,38704424,에즈헤어라운지 목동1호점,1,1,1,3
7436,s18122449,18122449,모델헤어아트,1,1,1,3
7437,s20895531,20895531,미나김헤어월드,1,1,1,3
7438,s20910829,20910829,제이미용실,1,1,1,3
7439,s18812328,18812328,머리박사,1,1,1,3
7440,s20936992,20936992,터치터치미용실,1,1,1,3
7441,s1591789254,1591789254,토모토모,1,1,1,3
7442,s20883823,20883823,챨스프로헤어,1,1,1,3
7443,s1775385117,1775385117,놈스프로젝트,1,1,1,3
7444,s20895552,20895552,천지미용실,1,1,1,3
7445,s1676240769,1676240769,수헤어그라피,1,1,1,3
7446,s31397144,31397144,에덴헤어샵,1,1,1,3
7447,s20127439,20127439,더살롱유메,1,1,1,3
7448,s35221563,35221563,W헤어 신당역점,1,1,1,3
7449,s20845532,20845532,헤어웨이스,1,1,1,3
7450,s20865012,20865012,송이헤어샵,1,1,1,3
7451,s20845609,20845609,머리사랑,1,1,1,3
7452,s1097878687,1097878687,사랑헤어,1,1,1,3
7453,s1604641809,1604641809,포도나무,1,1,1,3
7454,s11868227,11868227,박이수헤어탑,1,1,1,3
7455,s20845353,20845353,박용길헤어파크,1,1,1,3
7456,s1858873968,1858873968,어썸헤어,1,1,1,3
7457,s1057414195,1057414195,서당헤어,1,1,1,3
7458,s20845693,20845693,박서영헤어샵,1,1,1,3
7459,s1447735627,1447735627,아름다운헤어샵,1,1,1,3
7460,s1754098757,1754098757,영미용실,1,1,1,3
7461,s1541618813,1541618813,헤븐헤어,1,1,1,3
7462,s1587781427,1587781427,중,1,1,1,3
7463,s20857079,20857079,뽀그리헤어샵,1,1,1,3
7464,s67488074,67488074,이정헤어,1,1,1,3
7465,s1537906802,1537906802,김소현미용실,1,1,1,3
7466,s20896507,20896507,쥬쥬헤어,1,1,1,3
7467,s20837957,20837957,헤어갤러리,1,1,1,3
7468,s1281667894,1281667894,웨이브헤어샾,1,1,1,3
7469,s1503521149,1503521149,개미미용실,1,1,1,3
7470,s1172216998,1172216998,미장원에서,1,1,1,3
7471,s30868175,30868175,미소헤어샵,1,1,1,3
7472,s21823349,21823349,라베샤,1,1,1,3
7473,s34348702,34348702,에스헤어,1,1,1,3
7474,s121399007,121399007,서희살롱,1,1,1,3
7475,s20826142,20826142,라온헤어샵,1,1,1,3
7476,s1190657396,1190657396,송희경헤어,1,1,1,3
7477,s1587901769,1587901769,하니헤어,1,1,1,3
7478,s18822449,18822449,송수진헤어살롱,1,1,1,3
7479,s1275504596,1275504596,빠뜨헤어룩,1,1,1,3
7480,s20925888,20925888,선진헤어아트,1,1,1,3
7481,s20833932,20833932,Y2헤어,1,1,1,3
7482,s36803948,36803948,원헤어샵,1,1,1,3
7483,s1949797042,1949797042,헤어모션,1,1,1,3
7484,s18821823,18821823,수빈헤어라인,1,1,1,3
7485,s1484683602,1484683602,깜장머리,1,1,1,3
7486,s11609797,11609797,헤어 아뜨리에,1,1,1,3
7487,s1546690164,1546690164,혜주헤어샵,1,1,1,3
7488,sk18081805,k18081805,라경미용실,1,1,1,3
7489,s18422848,18422848,미성헤어라인,1,1,1,3
7490,s20910981,20910981,별미용실,1,1,1,3
7491,s1660560045,1660560045,첫눈에반하게,1,1,1,3
7492,s1098088747,1098088747,헤어뷰티,1,1,1,3
7493,s18091575,18091575,신순오미용실,1,1,1,3
7494,s20895649,20895649,디오헤어,1,1,1,3
7495,s1925782798,1925782798,박가현헤어,1,1,1,3
7496,s18423422,18423422,수앤미헤어,1,1,1,3
7497,s20853393,20853393,코코헤어,1,1,1,3
7498,s20838660,20838660,대화헤어샵,1,1,1,3
7499,s36237186,36237186,태후,1,1,1,3
7500,s18570093,18570093,조희미용실,1,1,1,3
7501,s1824680184,1824680184,수정헤어라인,1,1,1,3
7502,s37257427,37257427,스타일리스트 Y,1,1,1,3
7503,s530053963,530053963,더헤어,1,1,1,3
7504,s1518540550,1518540550,코코헤어,1,1,1,3
7505,s18406983,18406983,진헤어샵,1,1,1,3
7506,s1944899689,1944899689,미헤어,1,1,1,3
7507,s1812004806,1812004806,볼륨미용실,1,1,1,3
7508,s20863675,20863675,시크헤어,1,1,1,3
7509,s570885842,570885842,윤지영살롱,1,1,1,3
7510,s20855781,20855781,위드미헤어,1,1,1,3
7511,s1296152983,1296152983,태후사랑방화1호점,1,1,1,3
7512,s20879321,20879321,헤어루즈,1,1,1,3
7513,s20913395,20913395,정미용실,1,1,1,3
7514,s37558999,37558999,쎄라노미용실,1,1,1,3
7515,s1188965294,1188965294,머리못하는집 내발산114호점,1,1,1,3
7516,s37801210,37801210,M헤어,1,1,1,3
7517,s20832852,20832852,가위소리,1,1,1,3
7518,s1772873123,1772873123,미용함뷰티솔루션,1,1,1,3
7519,s38426427,38426427,연우헤어,1,1,1,3
7520,s1944098105,1944098105,포맨,1,1,1,3
7521,s38407650,38407650,헵시바헤어,1,1,1,3
7522,s20832776,20832776,은혜미용실,1,1,1,3
7523,s1391851166,1391851166,지선헤어클럽,1,1,1,3
7524,s1872462945,1872462945,태후사랑 발산점,1,1,1,3
7525,s37565491,37565491,시드니헤어,1,1,1,3
7526,s1427243554,1427243554,헤어바이 미,1,1,1,3
7527,s1288300014,1288300014,이끌림헤어,1,1,1,3
7528,s1864291301,1864291301,이영주헤어,1,1,1,3
7529,s1987124565,1987124565,태후사랑 내발산점,1,1,1,3
7530,s1668583618,1668583618,영헤어칼라,1,1,1,3
7531,s1826860156,1826860156,영헤어칼라,1,1,1,3
7532,s1074610537,1074610537,하비비미용실,1,1,1,3
7533,s1742671305,1742671305,더헤어감동2호점,1,1,1,3
7534,s1228759225,1228759225,미스터헤어,1,1,1,3
7535,s122268038,122268038,헤어쩡,1,1,1,3
7536,s1554079419,1554079419,앞머리삼백원,1,1,1,3
7537,s38654571,38654571,라엘헤어,1,1,1,3
7538,s33579932,33579932,비첸헤어,1,1,1,3
7539,s36416768,36416768,미학,1,1,1,3
7540,s1263238473,1263238473,더그루밍,1,1,1,3
7541,s1113187824,1113187824,타임플러스,1,1,1,3
7542,s1388086009,1388086009,IN HAIR,1,1,1,3
7543,s1499848502,1499848502,가인헤어,1,1,1,3
7544,s36871026,36871026,영자의전성시대,1,1,1,3
7545,s1372508613,1372508613,하나헤어박스까치산점,1,1,1,3
7546,s38729075,38729075,여원헤어,1,1,1,3
7547,s38263541,38263541,소라미용실,1,1,1,3
7548,s38307622,38307622,예시카헤어,1,1,1,3
7549,s1403938386,1403938386,하루헤어 가양점,1,1,1,3
7550,s1207453734,1207453734,다온헤어,1,1,1,3
7551,s1874679921,1874679921,주주헤어샵,1,1,1,3
7552,s1625945023,1625945023,오땡큐 송정역점,1,1,1,3
7553,s1292129394,1292129394,브라운브러쉬 홈플러스 가양점,1,1,1,3
7554,s1388888388,1388888388,라라헤어염색,1,1,1,3
7555,s1147395079,1147395079,L style beauty salon,1,1,1,3
7556,s13150992,13150992,머리하는날,1,1,1,3
7557,s1274825590,1274825590,헤어빈,1,1,1,3
7558,s1043871778,1043871778,나이스가이 염창점,1,1,1,3
7559,s1620300226,1620300226,태후사랑 화곡본동점,1,1,1,3
7560,s1427152003,1427152003,엘라헤어,1,1,1,3
7561,s18330259,18330259,블루클럽 염창점,1,1,1,3
7562,s1695716622,1695716622,청년헤어,1,1,1,3
7563,s1135998926,1135998926,퍼플헤어,1,1,1,3
7564,s1431531510,1431531510,올리브와 뽀빠이,1,1,1,3
7565,s1411620306,1411620306,블루클럽 우장산역점,1,1,1,3
7566,s20932553,20932553,준미용실,1,1,1,3
7567,s1163375794,1163375794,may hair,1,1,1,3
7568,s1776809639,1776809639,헤어살롱꽃처럼,1,1,1,3
7569,s35581550,35581550,아라미스헤어,1,1,1,3
7570,s1060136086,1060136086,티니헤어,1,1,1,3
7571,s38260346,38260346,메세나뷰티,1,1,1,3
7572,s237996657,237996657,예쁨주의보,1,1,1,3
7573,s798251214,798251214,에스더미용실,1,1,1,3
7574,s38344790,38344790,아지트 헤어,1,1,1,3
7575,s38382447,38382447,보니타헤어,1,1,1,3
7576,s1828783737,1828783737,이홍남성컷트,1,1,1,3
7577,s85278772,85278772,좋은머리,1,1,1,3
7578,s20836504,20836504,헤어블리스,1,1,1,3
7579,s1568276768,1568276768,엠제이헤어,1,1,1,3
7580,s1119879835,1119879835,인헤어,1,1,1,3
7581,s1615167508,1615167508,오페라헤어살롱,1,1,1,3
7582,s1228961494,1228961494,판도라 헤어,1,1,1,3
7583,s1675544114,1675544114,아이엠제니,1,1,1,3
7584,s1491585386,1491585386,블루클럽 마곡점,1,1,1,3
7585,s1278822407,1278822407,하리헤어샵,1,1,1,3
7586,s20828837,20828837,진아헤어,1,1,1,3
7587,s426394107,426394107,헤어블라썸,1,1,1,3
7588,s20901893,20901893,바비헤어,1,1,1,3
7589,s33352136,33352136,구피샵 화곡남부점,1,1,1,3
7590,s1971696536,1971696536,살롱루루헤어,1,1,1,3
7591,s985714242,985714242,꽃길헤어,1,1,1,3
7592,s1159380009,1159380009,태후사랑 등촌3동점,1,1,1,3
7593,s1608020390,1608020390,씨밀레헤어,1,1,1,3
7594,s1631438898,1631438898,별헤어샵,1,1,1,3
7595,s21710649,21710649,지앤미헤어,1,1,1,3
7596,s1077715360,1077715360,이지헤어,1,1,1,3
7597,s18412181,18412181,풍경헤어,1,1,1,3
7598,s36224893,36224893,끌림헤어,1,1,1,3
7599,s1531139525,1531139525,헤어DJ,1,1,1,3
7600,s771348020,771348020,민앤솔헤어,1,1,1,3
7601,s38217962,38217962,헤어그리기,1,1,1,3
7602,s37168865,37168865,호산나미용실,1,1,1,3
7603,s907094561,907094561,이헤어닷컴,1,1,1,3
7604,sk1419249766,k1419249766,헤어디제이(헤어DJ),1,1,1,3
7605,s33758099,33758099,살롱드뜨레,1,1,1,3
7606,s1408142161,1408142161,미장원by지연,1,1,1,3
7607,s11728772,11728772,나이스가이 방화점,1,1,1,3
7608,s36643185,36643185,리본헤어,1,1,1,3
7609,s1506206973,1506206973,엠제이헤어,1,1,1,3
7610,s1390010044,1390010044,조은주헤어,1,1,1,3
7611,s1034854031,1034854031,스타일맨 방화사거리지점,1,1,1,3
7612,s1583247660,1583247660,헤어 반함,1,1,1,3
7613,s38018864,38018864,루시헤어,1,1,1,3
7614,s31401393,31401393,명동헤어,1,1,1,3
7615,s30925869,30925869,예원헤어,1,1,1,3
7616,s34357159,34357159,제니스헤어,1,1,1,3
7617,s20940130,20940130,연희헤어,1,1,1,3
7618,s18411564,18411564,개성연출,1,1,1,3
7619,s20836669,20836669,제이제이헤어,1,1,1,3
7620,s1744334290,1744334290,토리헤어 까치산역점,1,1,1,3
7621,s1306792136,1306792136,룬붙임머리,1,1,1,3
7622,s1188527552,1188527552,헤어419,1,1,1,3
7623,s98230970,98230970,청담헤어,1,1,1,3
7624,s36866561,36866561,헤어살롱 밀가 까치산점,1,1,1,3
7625,s1517638584,1517638584,애비로드 헤어,1,1,1,3
7626,s1219305263,1219305263,백구사헤어플랜,1,1,1,3
7627,s38303714,38303714,예쁘다 슈,1,1,1,3
7628,s1267692623,1267692623,파마의집,1,1,1,3
7629,s36005206,36005206,진흥,1,1,1,3
7630,s1532042863,1532042863,눈부신헤어,1,1,1,3
7631,s37725602,37725602,밀팜hair,1,1,1,3
7632,s34356506,34356506,비비헤어,1,1,1,3
7633,s1231558042,1231558042,공감헤어,1,1,1,3
7634,s822218451,822218451,승희미용실,1,1,1,3
7635,s102511979,102511979,마녀헤어,1,1,1,3
7636,s1764929268,1764929268,머리가 우장산역점,1,1,1,3
7637,s13153736,13153736,여우머리,1,1,1,3
7638,s20909574,20909574,NiceGuy방화역점,1,1,1,3
7639,s1751238442,1751238442,빈남성컷전문점,1,1,1,3
7640,s1858118463,1858118463,OGADA HAIR,1,1,1,3
7641,s1158296234,1158296234,머리이야기,1,1,1,3
7642,s1369508473,1369508473,이지헤어,1,1,1,3
7643,s1991084971,1991084971,예닮헤어,1,1,1,3
7644,s1994388386,1994388386,라움헤어,1,1,1,3
7645,s1135070158,1135070158,체인지헤어,1,1,1,3
7646,s38267544,38267544,이-쁘게헤어,1,1,1,3
7647,s31557390,31557390,지영헤어,1,1,1,3
7648,s1840904802,1840904802,JAL HAIR,1,1,1,3
7649,s1797010127,1797010127,채리움 헤어,1,1,1,3
7650,s1178103241,1178103241,박선영미용실,1,1,1,3
7651,s1950534367,1950534367,다른느낌 k3 02,1,1,1,3
7652,s1873430603,1873430603,더헤어,1,1,1,3
7653,s1624572705,1624572705,빨강머리앤미용실,1,1,1,3
7654,s37278754,37278754,가이소리,1,1,1,3
7655,s1989467324,1989467324,이종순헤어샵,1,1,1,3
7656,s36699751,36699751,헤어뷰,1,1,1,3
7657,s37912283,37912283,헤어유,1,1,1,3
7658,s34532752,34532752,남성컷트클럽 방화점,1,1,1,3
7659,s1373055726,1373055726,카렌헤어스타일링,1,1,1,3
7660,s20867572,20867572,이지헤어샵,1,1,1,3
7661,s38737461,38737461,스위치헤어,1,1,1,3
7662,s1063075758,1063075758,준헤어아트,1,1,1,3
7663,s1083475410,1083475410,알로하헤어,1,1,1,3
7664,s1255185955,1255185955,미앤유헤어,1,1,1,3
7665,s1300638700,1300638700,준헤어라떼,1,1,1,3
7666,s20871564,20871564,GuyCut,1,1,1,3
7667,s20894336,20894336,신세계헤어샵,1,1,1,3
7668,s20875211,20875211,권헤어,1,1,1,3
7669,s860975010,860975010,라벨르헤어,1,1,1,3
7670,s922036707,922036707,토리헤어 우장산역점,1,1,1,3
7671,s1113792272,1113792272,아르보떼화곡본점,1,1,1,3
7672,s32814791,32814791,힐링헤어,1,1,1,3
7673,s20883086,20883086,애플헤어,1,1,1,3
7674,s1353168579,1353168579,늘펌헤어,1,1,1,3
7675,s1152897164,1152897164,MC헤어,1,1,1,3
7676,s18929589,18929589,신디헤어,1,1,1,3
7677,s1710105338,1710105338,최은지 미용실,1,1,1,3
7678,s1051962427,1051962427,파브헤어,1,1,1,3
7679,s426812031,426812031,퀸즈헤어,1,1,1,3
7680,s1040400816,1040400816,청담헤어,1,1,1,3
7681,s19717782,19717782,샤이니헤어샵,1,1,1,3
7682,s19556488,19556488,KBS88헤어넷,1,1,1,3
7683,s20909829,20909829,권서령헤어샵,1,1,1,3
7684,s1349896583,1349896583,아르보헤어,1,1,1,3
7685,s1081602789,1081602789,살롱비앙,1,1,1,3
7686,s1754006073,1754006073,더헤어,1,1,1,3
7687,s20879695,20879695,현미용실,1,1,1,3
7688,s914152607,914152607,샤론머리방,1,1,1,3
7689,s20887397,20887397,헤어플러스,1,1,1,3
7690,s1290297284,1290297284,세화미용실,1,1,1,3
7691,s20879724,20879724,에스타미용실,1,1,1,3
7692,s1827665223,1827665223,민경미헤어뉴스,1,1,1,3
7693,s1057154370,1057154370,혜영머리방,1,1,1,3
7694,s145727799,145727799,솔머리방,1,1,1,3
7695,s20898713,20898713,정헤어랜드,1,1,1,3
7696,s1088480245,1088480245,현숙미용실,1,1,1,3
7697,s20860564,20860564,유진헤어리더,1,1,1,3
7698,s1636883526,1636883526,황정임헤어모드,1,1,1,3
7699,s94833767,94833767,토리헤어 서울대녹두점,1,1,1,3
7700,s37873519,37873519,지노헤어 서울대점,1,1,1,3
7701,s19873019,19873019,에뜨르보 1호점,1,1,1,3
7702,s1019636043,1019636043,피오레,1,1,1,3
7703,s1581009247,1581009247,바이폴,1,1,1,3
7704,s37695672,37695672,K2미용실,1,1,1,3
7705,s694389829,694389829,지베르니헤어,1,1,1,3
7706,s1418383865,1418383865,헤어포인트,1,1,1,3
7707,s20840976,20840976,오정희헤어샵,1,1,1,3
7708,s1800147207,1800147207,효정미용실,1,1,1,3
7709,s38673400,38673400,순수,1,1,1,3
7710,s97746962,97746962,리헤어,1,1,1,3
7711,s18203156,18203156,성신미용실,1,1,1,3
7712,s18729613,18729613,은미용샾,1,1,1,3
7713,s20887327,20887327,나나미용실,1,1,1,3
7714,s254147919,254147919,진머리방,1,1,1,3
7715,s1699998795,1699998795,모두다헤어살롱,1,1,1,3
7716,s1026232355,1026232355,최숙자스타일리쉬,1,1,1,3
7717,s1955261012,1955261012,진머리방,1,1,1,3
7718,s1382916806,1382916806,김미용실,1,1,1,3
7719,s18203145,18203145,조민미용실,1,1,1,3
7720,s18695046,18695046,용미용실,1,1,1,3
7721,s18212080,18212080,현미용실,1,1,1,3
7722,s18717086,18717086,윤아미용실,1,1,1,3
7723,s603224046,603224046,진선머리방,1,1,1,3
7724,s1889870269,1889870269,윤미용실,1,1,1,3
7725,s36005211,36005211,열린미용실,1,1,1,3
7726,s38561164,38561164,미랑컬헤어 서울대점,1,1,1,3
7727,s1557541623,1557541623,마샬미용실,1,1,1,3
7728,s20875696,20875696,그리로헤어뉴스,1,1,1,3
7729,s20898798,20898798,혜연미용실,1,1,1,3
7730,s580585065,580585065,위그맨,1,1,1,3
7731,s31526152,31526152,한올헤어,1,1,1,3
7732,s431017293,431017293,옥탑머리방,1,1,1,3
7733,s584874515,584874515,윤희미용실,1,1,1,3
7734,s1336971038,1336971038,경도뷰티샵,1,1,1,3
7735,s20929258,20929258,궁궐미용실,1,1,1,3
7736,s32250551,32250551,김용재헤어아트,1,1,1,3
7737,s18717723,18717723,김진선헤어,1,1,1,3
7738,s90218015,90218015,클레오헤어,1,1,1,3
7739,s18719346,18719346,수진헤어라인,1,1,1,3
7740,s20887270,20887270,아테지헤어라인,1,1,1,3
7741,s18215233,18215233,레아헤어비스,1,1,1,3
7742,s362790741,362790741,프로젝트헤어,1,1,1,3
7743,s348228789,348228789,고운미용실,1,1,1,3
7744,s1840155313,1840155313,고운미용실,1,1,1,3
7745,s623792584,623792584,나드리헤어,1,1,1,3
7746,s18699259,18699259,서연헤어라인,1,1,1,3
7747,s20887384,20887384,문성희헤어라인,1,1,1,3
7748,s38508394,38508394,수진미용실,1,1,1,3
7749,s18873185,18873185,수진미용실,1,1,1,3
7750,s18706897,18706897,수진미용실,1,1,1,3
7751,s20877911,20877911,수진헤어살롱,1,1,1,3
7752,s698761493,698761493,백합헤어샵,1,1,1,3
7753,s13155704,13155704,김창숙미용실,1,1,1,3
7754,s20940604,20940604,로레알헤어모드,1,1,1,3
7755,s1797416718,1797416718,쁘띠꼬모헤어,1,1,1,3
7756,s20864429,20864429,전경숙미용실,1,1,1,3
7757,s1849678004,1849678004,호감,1,1,1,3
7758,s1570241075,1570241075,순수,1,1,1,3
7759,s20481080,20481080,스페이스 헤어,1,1,1,3
7760,s18717197,18717197,까까머리미용실,1,1,1,3
7761,s1579344928,1579344928,헤어살롱엘,1,1,1,3
7762,s38737499,38737499,아찌헤어,1,1,1,3
7763,s1887754246,1887754246,폭스헤어,1,1,1,3
7764,s1161613107,1161613107,샤로수헤어,1,1,1,3
7765,s18731167,18731167,킹카헤어샵 서울대점,1,1,1,3
7766,s1820285898,1820285898,더리치헤어,1,1,1,3
7767,s31401872,31401872,헤어스케치,1,1,1,3
7768,s1057874394,1057874394,효현미용실,1,1,1,3
7769,s18723669,18723669,끌레오,1,1,1,3
7770,s1335921844,1335921844,동방이용원,1,1,1,3
7771,s20932931,20932931,김창남성전용,1,1,1,3
7772,s20936852,20936852,정미용실,1,1,1,3
7773,s20860340,20860340,한기숙헤어아트,1,1,1,3
7774,s20940621,20940621,마샬헤어샵,1,1,1,3
7775,s20837110,20837110,에스더헤어샵,1,1,1,3
7776,s37531963,37531963,민정미용실,1,1,1,3
7777,s20833350,20833350,다정미용실,1,1,1,3
7778,s20924819,20924819,더민스헤어,1,1,1,3
7779,s1666777546,1666777546,공감헤어,1,1,1,3
7780,s1818549552,1818549552,이미지헤어,1,1,1,3
7781,s1218333697,1218333697,헤어아트,1,1,1,3
7782,s33305782,33305782,구피샵 방화점,1,1,1,3
7783,s18953025,18953025,선헤어스케치,1,1,1,3
7784,s1009298830,1009298830,새마을미장원,1,1,1,3
7785,s18381212,18381212,이지헤어,1,1,1,3
7786,s1743164766,1743164766,태후사랑 방화방신시장점,1,1,1,3
7787,s1227504332,1227504332,민영헤어,1,1,1,3
7788,s31116267,31116267,TJ헤어,1,1,1,3
7789,s1626196068,1626196068,이쁜이헤어,1,1,1,3
7790,s1138162291,1138162291,끄러모아,1,1,1,3
7791,s1948226524,1948226524,나비헤어,1,1,1,3
7792,s1993642295,1993642295,끌림헤어,1,1,1,3
7793,s1003920727,1003920727,블루클럽 발산역점,1,1,1,3
7794,sk1360283274,k1360283274,남성커트헤어클럽,1,1,1,3
7795,s1945754704,1945754704,블루클럽 내발산점,1,1,1,3
7796,s1730462641,1730462641,싸다헤어,1,1,1,3
7797,s1917795763,1917795763,살롱드몽,1,1,1,3
7798,s1976067339,1976067339,망고헤어,1,1,1,3
7799,s1600882355,1600882355,김태선미용실,1,1,1,3
7800,s1164390334,1164390334,아우라헤어살롱,1,1,1,3
7801,s20917246,20917246,제니스헤어,1,1,1,3
7802,s1528656903,1528656903,수미용실,1,1,1,3
7803,s1505784209,1505784209,쁘띠헤어,1,1,1,3
7804,s1308160384,1308160384,제이미용실,1,1,1,3
7805,s1327214305,1327214305,필리아헤어,1,1,1,3
7806,s20894546,20894546,신데렐라,1,1,1,3
7807,s20848271,20848271,머리예쁜나라,1,1,1,3
7808,s1191725674,1191725674,화곡퀸즈헤나미용실,1,1,1,3
7809,s1505206768,1505206768,수헤어샵,1,1,1,3
7810,s1370172503,1370172503,고마워샵,1,1,1,3
7811,s1732352537,1732352537,정다운미용실,1,1,1,3
7812,s1220173560,1220173560,뷰티인사이드,1,1,1,3
7813,s1121340912,1121340912,민이랑헤어,1,1,1,3
7814,s31729720,31729720,에스헤어디자인,1,1,1,3
7815,s1639672088,1639672088,커트&컷,1,1,1,3
7816,s1444595187,1444595187,예쁜여우헤어,1,1,1,3
7817,s20871336,20871336,이안헤어,1,1,1,3
7818,s1144098430,1144098430,빨강머리샵,1,1,1,3
7819,s36005208,36005208,까실미,1,1,1,3
7820,s1489176995,1489176995,디자이너윤헤어샵,1,1,1,3
7821,s1364548285,1364548285,몽코젤 헤어살롱,1,1,1,3
7822,s1641042349,1641042349,맨인블루 발산점,1,1,1,3
7823,s1963646344,1963646344,IM hair,1,1,1,3
7824,s1674364434,1674364434,주연미용실,1,1,1,3
7825,s18706447,18706447,프로헤어,1,1,1,3
7826,s20864210,20864210,현대미용실,1,1,1,3
7827,s18192992,18192992,진미용실,1,1,1,3
7828,s18698154,18698154,서순옥헤어,1,1,1,3
7829,s20848942,20848942,연주미용실,1,1,1,3
7830,s839249718,839249718,이스트엘,1,1,1,3
7831,s132278499,132278499,썬헤어샵,1,1,1,3
7832,s20550920,20550920,마녀늑대의머리카락에,1,1,1,3
7833,s558324204,558324204,에이치인헤어,1,1,1,3
7834,s257767035,257767035,MJ헤어,1,1,1,3
7835,s20879681,20879681,지은헤어,1,1,1,3
7836,s20871978,20871978,블레슈헤어,1,1,1,3
7837,s1135783029,1135783029,지씨네헤어,1,1,1,3
7838,s125466183,125466183,현미용실,1,1,1,3
7839,s20925462,20925462,중앙미용실,1,1,1,3
7840,s20852577,20852577,신성헤어,1,1,1,3
7841,s98684500,98684500,축복미용실,1,1,1,3
7842,s18701687,18701687,인순이헤어샵,1,1,1,3
7843,s20921625,20921625,햅번헤어,1,1,1,3
7844,s83680792,83680792,한일헤어아떼,1,1,1,3
7845,s20902530,20902530,유정헤어모드,1,1,1,3
7846,s20852831,20852831,광주미용실,1,1,1,3
7847,s1100287379,1100287379,스타일맨 헤어샵,1,1,1,3
7848,s31400487,31400487,로뎀헤어,1,1,1,3
7849,s1490370131,1490370131,헤어뉴스,1,1,1,3
7850,s1337025904,1337025904,티라노헤어,1,1,1,3
7851,s1584070831,1584070831,하이엔드헤어살롱,1,1,1,3
7852,s1255507863,1255507863,맨케이브,1,1,1,3
7853,s13090164,13090164,박철헤어센타,1,1,1,3
7854,s11882352,11882352,다미헤어 목동1호점,1,1,1,3
7855,s1691927867,1691927867,헤어플레이,1,1,1,3
7856,s18928528,18928528,지오지아,1,1,1,3
7857,s1966178269,1966178269,에덴헤어,1,1,1,3
7858,s20933747,20933747,임재현미용실,1,1,1,3
7859,s32390218,32390218,블루클럽 봉천현대시장점,1,1,1,3
7860,s38724204,38724204,뷰헤어,1,1,1,3
7861,s1147520601,1147520601,감성더하기,1,1,1,3
7862,s1166581995,1166581995,HAIR DK,1,1,1,3
7863,s1561863704,1561863704,P미용실,1,1,1,3
7864,s37049518,37049518,꾸찌헤어,1,1,1,3
7865,s31402509,31402509,라비다,1,1,1,3
7866,s34358977,34358977,포맨,1,1,1,3
7867,s18192986,18192986,춤추는가위손,1,1,1,3
7868,s1054824522,1054824522,시크헤어,1,1,1,3
7869,s20894361,20894361,헤어정,1,1,1,3
7870,s20111696,20111696,마벨헤어,1,1,1,3
7871,s1725553585,1725553585,미인헤어,1,1,1,3
7872,s37179689,37179689,헤어살롱제이,1,1,1,3
7873,s1519569641,1519569641,두언니 헤어,1,1,1,3
7874,s1357080899,1357080899,동네방네미용실,1,1,1,3
7875,s18397338,18397338,상투머리,1,1,1,3
7876,s20855898,20855898,동해헤어필,1,1,1,3
7877,s20832784,20832784,장윤정헤어,1,1,1,3
7878,s20940071,20940071,열린미용실,1,1,1,3
7879,s38250770,38250770,심쿵헤어,1,1,1,3
7880,s1569992343,1569992343,김선영헤어,1,1,1,3
7881,s648317233,648317233,감성헤어,1,1,1,3
7882,s1159032766,1159032766,글로리아미용실,1,1,1,3
7883,sk391573125,k391573125,도도헤어,1,1,1,3
7884,s11588725,11588725,폼헤어아트,1,1,1,3
7885,s13517584,13517584,헤라헤어샵,1,1,1,3
7886,s20924977,20924977,퀸즈헤어,1,1,1,3
7887,s1177333455,1177333455,미장헤어,1,1,1,3
7888,s1010305921,1010305921,제오헤어 목동점,1,1,1,3
7889,s1150297487,1150297487,엘리시아샵,1,1,1,3
7890,s20902152,20902152,미즈헤어,1,1,1,3
7891,s1966108578,1966108578,에스헤어스타일,1,1,1,3
7892,s36782183,36782183,1번가헤어,1,1,1,3
7893,s36084498,36084498,인팩트오타쿠 목동점,1,1,1,3
7894,s36947364,36947364,럭셔리청담헤어,1,1,1,3
7895,s1459956904,1459956904,나드리헤어,1,1,1,3
7896,s1147520341,1147520341,정미용실,1,1,1,3
7897,s20940080,20940080,송혜수뷰티케어,1,1,1,3
7898,s38261887,38261887,빨강머리샾미용실,1,1,1,3
7899,s20863640,20863640,폼내뽐내헤어모드,1,1,1,3
7900,s18406045,18406045,꾸미지오헤어샾,1,1,1,3
7901,s1375273803,1375273803,보아스헤어아트,1,1,1,3
7902,s18926696,18926696,자란다헤어샵,1,1,1,3
7903,s1216327073,1216327073,루리 헤어살롱,1,1,1,3
7904,s1096240097,1096240097,아임미헤어살롱,1,1,1,3
7905,s13460128,13460128,헤어필미용실,1,1,1,3
7906,s260799894,260799894,머리하는날,1,1,1,3
7907,s20886810,20886810,청담헤어,1,1,1,3
7908,s20939960,20939960,수미용실,1,1,1,3
7909,s1581285211,1581285211,김정현헤어샵,1,1,1,3
7910,s1454654531,1454654531,라라쌀롱,1,1,1,3
7911,s34850415,34850415,수헤어샵,1,1,1,3
7912,s20867680,20867680,주쌤헤어,1,1,1,3
7913,s18412152,18412152,아리따운미용실,1,1,1,3
7914,s18388279,18388279,한스헤어,1,1,1,3
7915,s37987436,37987436,Ms 미즈헤어,1,1,1,3
7916,s1302168983,1302168983,주연헤어,1,1,1,3
7917,s20936285,20936285,강기빈미용실,1,1,1,3
7918,s20924818,20924818,T는머리,1,1,1,3
7919,s20859974,20859974,공은업헤어,1,1,1,3
7920,s18381214,18381214,수미수미용실,1,1,1,3
7921,s35915092,35915092,라움헤어,1,1,1,3
7922,s20898330,20898330,임경이헤어붐,1,1,1,3
7923,s20894484,20894484,글로리헤어센스,1,1,1,3
7924,s475673399,475673399,머리하기좋은날,1,1,1,3
7925,s1959755153,1959755153,블루클럽,1,1,1,3
7926,s18385425,18385425,희정헤어샵,1,1,1,3
7927,s20005665,20005665,오빈헤어콜렉션,1,1,1,3
7928,s20871296,20871296,화이트미용실,1,1,1,3
7929,s35606211,35606211,와이제이헤어클럽,1,1,1,3
7930,s18327045,18327045,유스헤어,1,1,1,3
7931,s19500462,19500462,강임헤어,1,1,1,3
7932,s20928629,20928629,김민정헤어샵,1,1,1,3
7933,s1505054577,1505054577,외출준비미용실,1,1,1,3
7934,s19480237,19480237,여우미가,1,1,1,3
7935,s20863811,20863811,샹스헤어플랜,1,1,1,3
7936,s20863717,20863717,모던헤어,1,1,1,3
7937,s18404281,18404281,B&B헤어,1,1,1,3
7938,s13153623,13153623,H STYLE헤어살롱 강서구청점,1,1,1,3
7939,s18394442,18394442,예손파워시티,1,1,1,3
7940,s20824976,20824976,신현선헤어아트,1,1,1,3
7941,s31730718,31730718,미가헤어테크,1,1,1,3
7942,s20906036,20906036,예쁜미용실,1,1,1,3
7943,s18397280,18397280,써니루키헤어샵,1,1,1,3
7944,s1125048105,1125048105,썬헤어,1,1,1,3
7945,s20924729,20924729,필헤어스토리목동사거리점,1,1,1,3
7946,s1747582380,1747582380,브라운헤어,1,1,1,3
7947,sk1187387603,k1187387603,헤어갤러리,1,1,1,3
7948,s1734894436,1734894436,리오헤어샵,1,1,1,3
7949,s1616751250,1616751250,하희현HAIR,1,1,1,3
7950,s20909817,20909817,엔젤헤어,1,1,1,3
7951,s1145313075,1145313075,소원미용실,1,1,1,3
7952,s1646018088,1646018088,S헤어 화곡점,1,1,1,3
7953,s1511022117,1511022117,창포헤어샵,1,1,1,3
7954,s20828773,20828773,이빈헤어,1,1,1,3
7955,s20871297,20871297,Km헤어,1,1,1,3
7956,s20932474,20932474,헤어포인트,1,1,1,3
7957,s18386360,18386360,제니헤어,1,1,1,3
7958,s20913544,20913544,이지헤어,1,1,1,3
7959,s20840596,20840596,쿨헤어클럽,1,1,1,3
7960,s20928561,20928561,윤선헤어샵,1,1,1,3
7961,sk18413046,k18413046,마셀강토탈프라자,1,1,1,3
7962,s20871363,20871363,꽁뜨르미용실,1,1,1,3
7963,sk1435650590,k1435650590,큐사랑,1,1,1,3
7964,s1605527373,1605527373,아트헤어라인,1,1,1,3
7965,s13572412,13572412,정다운헤어스토리,1,1,1,3
7966,s1788977911,1788977911,정은헤어,1,1,1,3
7967,s20886715,20886715,헤어뱅크,1,1,1,3
7968,s20852236,20852236,리아헤어아트,1,1,1,3
7969,s1672446850,1672446850,정민재헤어샵,1,1,1,3
7970,s18931520,18931520,헤어스케치,1,1,1,3
7971,s18407852,18407852,자매미용타운,1,1,1,3
7972,s20905964,20905964,코디헤어뱅크,1,1,1,3
7973,s20863654,20863654,민지헤어아트,1,1,1,3
7974,s20883031,20883031,머리가예쁜사람들,1,1,1,3
7975,s20852157,20852157,헤어라면,1,1,1,3
7976,s20928611,20928611,버르장머리,1,1,1,3
7977,s20932350,20932350,헤어라인칼라,1,1,1,3
7978,s18368637,18368637,민헤어라인,1,1,1,3
7979,s1131186991,1131186991,엔젤헤어,1,1,1,3
7980,s36831144,36831144,헤어컬렉션,1,1,1,3
7981,s11643841,11643841,뽀끌레미용실,1,1,1,3
7982,s18951933,18951933,이가미장,1,1,1,3
7983,s18926751,18926751,명화헤어,1,1,1,3
7984,s20824795,20824795,우리동네미용실,1,1,1,3
7985,s18935855,18935855,민주헤어박스,1,1,1,3
7986,s1422262361,1422262361,수지미용실,1,1,1,3
7987,s18932164,18932164,프리스타일,1,1,1,3
7988,s18406986,18406986,손경애미용실,1,1,1,3
7989,s1936707010,1936707010,손경애헤어숍,1,1,1,3
7990,s20928688,20928688,사라미용실,1,1,1,3
7991,s20905962,20905962,공간미용실,1,1,1,3
7992,s1413016520,1413016520,플러스,1,1,1,3
7993,s1032816983,1032816983,플러스미용실,1,1,1,3
7994,s20894464,20894464,수은미용실,1,1,1,3
7995,s20921036,20921036,김명진미용실,1,1,1,3
7996,s18327027,18327027,샤넬미용실,1,1,1,3
7997,s1475741281,1475741281,춤추는헤어스캔들,1,1,1,3
7998,s20821028,20821028,월드미용실,1,1,1,3
7999,s20875152,20875152,박경애헤어리더,1,1,1,3
8000,s1049360702,1049360702,뷰티타임,1,1,1,3
8001,s20871350,20871350,프린세스헤어,1,1,1,3
8002,s34576325,34576325,와이케이헤어가양점,1,1,1,3
8003,s18368221,18368221,양윤정미용실,1,1,1,3
8004,s18385437,18385437,이남지미용실,1,1,1,3
8005,s12865439,12865439,유앤아이헤어,1,1,1,3
8006,s36005207,36005207,차순옥미용실,1,1,1,3
8007,s1322057406,1322057406,마셀강미용실,1,1,1,3
8008,s20932403,20932403,153헤어샵,1,1,1,3
8009,s18367268,18367268,박앤장헤어살롱,1,1,1,3
8010,s121975879,121975879,젠틀클럽,1,1,1,3
8011,s20913536,20913536,라푼젤,1,1,1,3
8012,sk31034568,k31034568,코코헤어,1,1,1,3
8013,s1016931080,1016931080,유니크살롱,1,1,1,3
8014,s1303726415,1303726415,보니타헤어,1,1,1,3
8015,s20875123,20875123,드림헤어,1,1,1,3
8016,s20898086,20898086,햅시바헤어,1,1,1,3
8017,s18414208,18414208,이수선미용실,1,1,1,3
8018,s32121510,32121510,마샬,1,1,1,3
8019,s1715571458,1715571458,이수연미용실,1,1,1,3
8020,s18938653,18938653,끌어모아,1,1,1,3
8021,s33706654,33706654,이설헤어 방화점,1,1,1,3
8022,s1070689410,1070689410,샤인헤어,1,1,1,3
8023,s1607914584,1607914584,유나헤어,1,1,1,3
8024,s20836629,20836629,Rebornhair,1,1,1,3
8025,s11729640,11729640,블루클럽 송정역점,1,1,1,3
8026,s54103798,54103798,황제헤어코코,1,1,1,3
8027,s20863527,20863527,Lee헤어샵,1,1,1,3
8028,s20898080,20898080,초이미용실,1,1,1,3
8029,s1945980284,1945980284,빠마앤까뜨,1,1,1,3
8030,s20886751,20886751,수헤어,1,1,1,3
8031,s36406687,36406687,일인샵헤어,1,1,1,3
8032,s1768475528,1768475528,미앤미헤어샵,1,1,1,3
8033,s1724622380,1724622380,나이스가이 신방화점,1,1,1,3
8034,s20856005,20856005,쥬얼리헤어샵,1,1,1,3
8035,s20844418,20844418,머리한순간,1,1,1,3
8036,s1291363355,1291363355,머리한순간,1,1,1,3
8037,s13153105,13153105,고범수뷰티,1,1,1,3
8038,s58272655,58272655,귀티나,1,1,1,3
8039,s18938126,18938126,가위소리,1,1,1,3
8040,s20828826,20828826,김진경헤어,1,1,1,3
8041,s1056455748,1056455748,원헤어,1,1,1,3
8042,s1199450199,1199450199,헬렌헤어,1,1,1,3
8043,s20890514,20890514,리즈헤어클럽,1,1,1,3
8044,s20832811,20832811,신은경헤어크리닉,1,1,1,3
8045,s20867611,20867611,장미헤어포인트,1,1,1,3
8046,s20855835,20855835,나래미용실,1,1,1,3
8047,s37104563,37104563,미미네살롱,1,1,1,3
8048,s35958588,35958588,오헤어,1,1,1,3
8049,s37491993,37491993,모드니 헤어,1,1,1,3
8050,s31317091,31317091,예서,1,1,1,3
8051,s35849290,35849290,청담헤어,1,1,1,3
8052,s37288940,37288940,라포레 미용실,1,1,1,3
8053,s19569734,19569734,꾸미지오미용실,1,1,1,3
8054,s20824970,20824970,꾸미지오헤어,1,1,1,3
8055,s20913546,20913546,헤어닥터,1,1,1,3
8056,s1864669753,1864669753,모던헤어,1,1,1,3
8057,s18389565,18389565,민들레헤어화곡점,1,1,1,3
8058,s20863555,20863555,뷰티헤어,1,1,1,3
8059,s1667001191,1667001191,살롱드에비뉴 화곡점,1,1,1,3
8060,s19851640,19851640,아리수헤어살롱,1,1,1,3
8061,s1702929365,1702929365,데일리헤어,1,1,1,3
8062,s36399010,36399010,DO헤어,1,1,1,3
8063,s1027066653,1027066653,이지헤어,1,1,1,3
8064,s35562855,35562855,이건헤어아티스트,1,1,1,3
8065,s18426815,18426815,남자이야기,1,1,1,3
8066,s20861083,20861083,TOP헤어,1,1,1,3
8067,s1311206237,1311206237,수헤어,1,1,1,3
8068,s20836488,20836488,스타헤어클럽,1,1,1,3
8069,s1639751200,1639751200,이루다헤어샵,1,1,1,3
8070,s324898677,324898677,마샬헤어샵,1,1,1,3
8071,s1133385597,1133385597,압구정헤어,1,1,1,3
8072,s1584802447,1584802447,샬롬미용실,1,1,1,3
8073,s1846039642,1846039642,봄앤강헤어,1,1,1,3
8074,s20872455,20872455,헤어피카소,1,1,1,3
8075,s20914594,20914594,새로아헤어아트,1,1,1,3
8076,s18413403,18413403,쥬뗌므헤어,1,1,1,3
8077,s1652308551,1652308551,헤어살롱 끌로에,1,1,1,3
8078,s20905795,20905795,럭셔리헤어,1,1,1,3
8079,s20909755,20909755,헤어러브,1,1,1,3
8080,s20875122,20875122,가위소리,1,1,1,3
8081,s1228296975,1228296975,mash,1,1,1,3
8082,s18948354,18948354,헤어존,1,1,1,3
8083,s18927577,18927577,비채헤어,1,1,1,3
8084,s13119757,13119757,살롱드 민서,1,1,1,3
8085,s1791894156,1791894156,미션뷰티헤어,1,1,1,3
8086,s1159091544,1159091544,은빛헤어클럽,1,1,1,3
8087,s1647863373,1647863373,아르또 헤어 갤러리,1,1,1,3
8088,s18931928,18931928,깜장머리,1,1,1,3
8089,s20936394,20936394,다래헤어샵,1,1,1,3
8090,s1192575091,1192575091,이끌림헤어,1,1,1,3
8091,s20898126,20898126,이영애헤어,1,1,1,3
8092,s20863738,20863738,수정미용실,1,1,1,3
8093,s20883165,20883165,킴헤어,1,1,1,3
8094,s18938633,18938633,정엔정헤어,1,1,1,3
8095,s1451501240,1451501240,러브미용실,1,1,1,3
8096,s1312735051,1312735051,미다해헤어살롱,1,1,1,3
8097,s20921005,20921005,샤론미용실,1,1,1,3
8098,s1333958793,1333958793,다솔미용실,1,1,1,3
8099,s19412478,19412478,김금숙프로헤어,1,1,1,3
8100,s1626050841,1626050841,헤어이끌림,1,1,1,3
8101,s1079551133,1079551133,헤어스케치,1,1,1,3
8102,s1589936606,1589936606,JJ헤어샵,1,1,1,3
8103,s665687347,665687347,주헤어,1,1,1,3
8104,s1135639016,1135639016,희즈헤어,1,1,1,3
8105,s1033206376,1033206376,오늘헤어,1,1,1,3
8106,s37549343,37549343,놈헤어,1,1,1,3
8107,s34413460,34413460,에이치헤어,1,1,1,3
8108,s31950176,31950176,춘미용실,1,1,1,3
8109,s19977258,19977258,베아트리스,1,1,1,3
8110,s18940669,18940669,보스헤어샵,1,1,1,3
8111,s1543721362,1543721362,엠헤어,1,1,1,3
8112,s1390873428,1390873428,러블리샵,1,1,1,3
8113,s18935828,18935828,리즈헤어,1,1,1,3
8114,s1634722902,1634722902,차뷰티헤어,1,1,1,3
8115,s18394450,18394450,대원미용실,1,1,1,3
8116,s1027409476,1027409476,미소헤어,1,1,1,3
8117,s36005205,36005205,아산남성컷전문,1,1,1,3
8118,s18938051,18938051,김&김헤어,1,1,1,3
8119,s1910127960,1910127960,달리다 굼 헤어,1,1,1,3
8120,s38300428,38300428,어울림헤어,1,1,1,3
8121,s1350375554,1350375554,홍연화헤어케스팅,1,1,1,3
8122,s1440725943,1440725943,제이제이헤어샵,1,1,1,3
8123,s20058397,20058397,이리스헤어,1,1,1,3
8124,s20829957,20829957,준헤어샾,1,1,1,3
8125,s38642978,38642978,더 헤어,1,1,1,3
8126,s1766607783,1766607783,힐링헤어,1,1,1,3
8127,s1928076650,1928076650,댕기댕기미용실,1,1,1,3
8128,s1650429665,1650429665,백수연미용실,1,1,1,3
8129,s20910704,20910704,이설화헤어샾,1,1,1,3
8130,s1646375413,1646375413,미플러스,1,1,1,3
8131,s1680508703,1680508703,리즈헤어,1,1,1,3
8132,s20909822,20909822,헤어칼라,1,1,1,3
8133,s1903196343,1903196343,유화머리방,1,1,1,3
8134,s31401910,31401910,세원헤어라인,1,1,1,3
8135,s18835083,18835083,현아미용실,1,1,1,3
8136,s20526633,20526633,퍼펙트헤어살롱,1,1,1,3
8137,s20932318,20932318,in,1,1,1,3
8138,s20824870,20824870,도로시헤어,1,1,1,3
8139,s32116553,32116553,수헤어,1,1,1,3
8140,s20828977,20828977,유니원헤어,1,1,1,3
8141,s1830687238,1830687238,쿨헤어,1,1,1,3
8142,s1935884950,1935884950,파스텔헤어,1,1,1,3
8143,s20824908,20824908,플로체,1,1,1,3
8144,s20502684,20502684,한스헤어탑,1,1,1,3
8145,s20875131,20875131,헤어스타일,1,1,1,3
8146,s13151855,13151855,노블레스미용실,1,1,1,3
8147,s20924782,20924782,엘르헤어,1,1,1,3
8148,s38673603,38673603,헤어스토리 마벨,1,1,1,3
8149,s20913539,20913539,머리이야기,1,1,1,3
8150,s1804587619,1804587619,아르또 헤어,1,1,1,3
8151,s20824780,20824780,나두헤어,1,1,1,3
8152,s18937109,18937109,조희미용실,1,1,1,3
8153,s1906568695,1906568695,손영헤어샵,1,1,1,3
8154,s20940013,20940013,김민재헤어클리닉,1,1,1,3
8155,s20928664,20928664,열린미용실,1,1,1,3
8156,s1289168022,1289168022,헤어터치,1,1,1,3
8157,s20932384,20932384,솔담헤어,1,1,1,3
8158,s1743339790,1743339790,보보헤어,1,1,1,3
8159,s20855927,20855927,노랑머리앤,1,1,1,3
8160,s1899860466,1899860466,라니헤어샵,1,1,1,3
8161,s20890632,20890632,한스헤어,1,1,1,3
8162,s1145006496,1145006496,루나헤어,1,1,1,3
8163,s1999396994,1999396994,다헤어샵,1,1,1,3
8164,s20921135,20921135,오드리헤어샵,1,1,1,3
8165,s20879338,20879338,오렌지헤어짱,1,1,1,3
8166,s20921000,20921000,엄지머리방,1,1,1,3
8167,s20855877,20855877,은혜머리방,1,1,1,3
8168,s32096196,32096196,홍성희헤어스페이스,1,1,1,3
8169,s1142048041,1142048041,타미,1,1,1,3
8170,s20836692,20836692,이안미장,1,1,1,3
8171,s20863799,20863799,헤어체인지,1,1,1,3
8172,s37072392,37072392,m살롱헤어,1,1,1,3
8173,s33238760,33238760,쉬스토리,1,1,1,3
8174,s1731587426,1731587426,금성헤어,1,1,1,3
8175,s20832900,20832900,비타민헤어,1,1,1,3
8176,s18334133,18334133,가위손헤어센스,1,1,1,3
8177,s20913476,20913476,헤어플러스,1,1,1,3
8178,s1671054869,1671054869,조은향기헤어나라,1,1,1,3
8179,s18936320,18936320,끌레오헤어,1,1,1,3
8180,s18394444,18394444,예원헤어라인,1,1,1,3
8181,s18930573,18930573,플로렌스헤어,1,1,1,3
8182,s20894450,20894450,준앤미헤어,1,1,1,3
8183,s1036441268,1036441268,사과나무미용실,1,1,1,3
8184,s21892825,21892825,화려한외출,1,1,1,3
8185,s36303276,36303276,제이맨,1,1,1,3
8186,s1038068695,1038068695,진헤어스케치,1,1,1,3
8187,s18951323,18951323,미&끼,1,1,1,3
8188,s18382346,18382346,함나리헤어트랜드,1,1,1,3
8189,s20848457,20848457,박미선헤어아트,1,1,1,3
8190,s13151762,13151762,헤어메카,1,1,1,3
8191,s1707109969,1707109969,수헤어,1,1,1,3
8192,s1386797409,1386797409,다다헤어클럽,1,1,1,3
8193,s20848378,20848378,헤어포인트,1,1,1,3
8194,s548792407,548792407,런던헤어,1,1,1,3
8195,s1133482185,1133482185,헤어카페,1,1,1,3
8196,s1369259872,1369259872,용헤어테크닉,1,1,1,3
8197,s1988216823,1988216823,킴헤어아트,1,1,1,3
8198,s1509227025,1509227025,에스헤어,1,1,1,3
8199,s20820766,20820766,카라헤어화곡점,1,1,1,3
8200,s34350281,34350281,연진헤어,1,1,1,3
8201,s1370889576,1370889576,용헤어살롱,1,1,1,3
8202,s20936123,20936123,정진희헤어샵,1,1,1,3
8203,s20875208,20875208,파인첼로헤어샵,1,1,1,3
8204,s20940029,20940029,헤어케스팅,1,1,1,3
8205,s1405393980,1405393980,한사랑헤어샵,1,1,1,3
8206,s1006126360,1006126360,다원헤어,1,1,1,3
8207,s20871317,20871317,수헤어커커,1,1,1,3
8208,s18382063,18382063,헤어1380,1,1,1,3
8209,s19886301,19886301,헤어 스토리,1,1,1,3
8210,s1325437655,1325437655,나이스컷 남성 커트점 등촌점,1,1,1,3
8211,s20924954,20924954,동아미장,1,1,1,3
8212,s1619509792,1619509792,요술머리헤어,1,1,1,3
8213,s20828747,20828747,세실헤어,1,1,1,3
8214,s20890695,20890695,아름다운세상헤어샵,1,1,1,3
8215,s37687319,37687319,이훈plan30000미용실 목사2호점,1,1,1,3
8216,s1020586860,1020586860,웰빙헤어샵,1,1,1,3
8217,s20852105,20852105,엘라헤어,1,1,1,3
8218,s1564436807,1564436807,컷트클럽,1,1,1,3
8219,s64233792,64233792,미루헤어,1,1,1,3
8220,s1608141984,1608141984,머리못하는집 신방화 145호점,1,1,1,3
8221,s36939871,36939871,HAIR TEAM 720,1,1,1,3
8222,s1119772170,1119772170,블루클럽 신방화역점,1,1,1,3
8223,s38654192,38654192,W헤어살롱,1,1,1,3
8224,s37613187,37613187,오투30000 헤어,1,1,1,3
8225,s1596062153,1596062153,헤어 그리다,1,1,1,3
8226,s1060522687,1060522687,헤어스토리,1,1,1,3
8227,s1156557527,1156557527,윤정희헤어,1,1,1,3
8228,s1683729682,1683729682,마곡헤어,1,1,1,3
8229,s1825028240,1825028240,hair&J,1,1,1,3
8230,s1293355128,1293355128,휴앤샵헤어,1,1,1,3
8231,s1317252068,1317252068,스타일미용실,1,1,1,3
8232,s20924710,20924710,스타일헤어샵,1,1,1,3
8233,s20844501,20844501,준헤어아트,1,1,1,3
8234,s13152431,13152431,헤어플러스,1,1,1,3
8235,s34787514,34787514,헤어체인지,1,1,1,3
8236,s1429540165,1429540165,개성연출,1,1,1,3
8237,s1026565536,1026565536,동경미용실,1,1,1,3
8238,s649701758,649701758,알파미용실,1,1,1,3
8239,s18697188,18697188,덕인헤어센스,1,1,1,3
8240,s20843984,20843984,금성헤어샾,1,1,1,3
8241,s1715647232,1715647232,미인만들기,1,1,1,3
8242,s1002334367,1002334367,미도미용실,1,1,1,3
8243,s1293496127,1293496127,정지윤헤어아트,1,1,1,3
8244,s20878794,20878794,길헤어뱅크,1,1,1,3
8245,s1065614224,1065614224,아모레미용실,1,1,1,3
8246,s1639851191,1639851191,샤론헤어아트,1,1,1,3
8247,s35238498,35238498,신해숙헤어샵,1,1,1,3
8248,s1278302588,1278302588,H헤어커커,1,1,1,3
8249,sk17956565,k17956565,팡세미용실,1,1,1,3
8250,s20878719,20878719,진달래미용실,1,1,1,3
8251,s20848958,20848958,예쁜머리만들기,1,1,1,3
8252,s20844014,20844014,팡세헤어샵,1,1,1,3
8253,s37911046,37911046,헤어로펌,1,1,1,3
8254,s364308880,364308880,헬로제이샵,1,1,1,3
8255,s31887592,31887592,코코헤어,1,1,1,3
8256,s1220047049,1220047049,수비살롱,1,1,1,3
8257,s13155198,13155198,모짜르트헤어샵,1,1,1,3
8258,s18827834,18827834,채림헤어샵,1,1,1,3
8259,s20878717,20878717,샤론헤어월드,1,1,1,3
8260,s18826640,18826640,이은숙헤어&뷰티,1,1,1,3
8261,s20882580,20882580,마리앤미,1,1,1,3
8262,s1200138428,1200138428,테마미용실,1,1,1,3
8263,s1004718413,1004718413,뉴헤어,1,1,1,3
8264,s20851629,20851629,밀라노헤어컴,1,1,1,3
8265,s1208137785,1208137785,살롱드윤,1,1,1,3
8266,s1595750614,1595750614,정헤어,1,1,1,3
8267,s1309389805,1309389805,바바헤어,1,1,1,3
8268,s33109030,33109030,아띠헤어,1,1,1,3
8269,s18802748,18802748,윤선영헤어샵,1,1,1,3
8270,s20859396,20859396,행복헤어샾,1,1,1,3
8271,s1676286116,1676286116,캘리헤어,1,1,1,3
8272,s1556878582,1556878582,헤어보떼,1,1,1,3
8273,s38721956,38721956,두리헤어,1,1,1,3
8274,s18801095,18801095,갤러리아헤어샵,1,1,1,3
8275,s1498500401,1498500401,댕기헤어,1,1,1,3
8276,s1482565295,1482565295,윤주헤어샵 아차산점,1,1,1,3
8277,s18801868,18801868,엠제이헤어,1,1,1,3
8278,s20855226,20855226,미앤끼헤어샵,1,1,1,3
8279,s20839898,20839898,영주미용실,1,1,1,3
8280,s1704147593,1704147593,써니헤어,1,1,1,3
8281,s20882531,20882531,진헤어,1,1,1,3
8282,s18806407,18806407,희헤어클럽,1,1,1,3
8283,s17956584,17956584,거울공주헤어,1,1,1,3
8284,s18822870,18822870,차밍헤어,1,1,1,3
8285,s20840032,20840032,서미미용실,1,1,1,3
8286,s1002430127,1002430127,씨씨헤어라인,1,1,1,3
8287,s1918786345,1918786345,헤어공간,1,1,1,3
8288,sk17991434,k17991434,동경미용실,1,1,1,3
8289,s20832247,20832247,박영희헤어라인,1,1,1,3
8290,s18827258,18827258,예쁜머리만들기,1,1,1,3
8291,s20909209,20909209,그레이스,1,1,1,3
8292,s1645959671,1645959671,헤바헤어,1,1,1,3
8293,s1987191547,1987191547,베르샤헤어,1,1,1,3
8294,s1150072500,1150072500,머리천국,1,1,1,3
8295,s18830634,18830634,아가페헤어,1,1,1,3
8296,s1378335562,1378335562,은빈 미용실,1,1,1,3
8297,s20824140,20824140,헤어코디,1,1,1,3
8298,s36005221,36005221,조희미용실,1,1,1,3
8299,s1253172555,1253172555,이규리헤어,1,1,1,3
8300,s18830652,18830652,소문난미용실,1,1,1,3
8301,s20855248,20855248,성희헤어까페,1,1,1,3
8302,s1805338771,1805338771,린헤어,1,1,1,3
8303,s18825562,18825562,초원미용실,1,1,1,3
8304,s20863050,20863050,오정이헤어매니아,1,1,1,3
8305,s18015896,18015896,미래미용실,1,1,1,3
8306,s34182086,34182086,김명옥헤어스케치,1,1,1,3
8307,s1116715011,1116715011,고은머리,1,1,1,3
8308,s33351956,33351956,구피샵 자양점,1,1,1,3
8309,s20939539,20939539,이영희헤어뷰틱,1,1,1,3
8310,s17991401,17991401,백합미장원,1,1,1,3
8311,s1120944005,1120944005,김은경머리방,1,1,1,3
8312,s20863197,20863197,에덴미용실,1,1,1,3
8313,s20920486,20920486,뷰티플러스,1,1,1,3
8314,s18830393,18830393,멋샘헤어센스,1,1,1,3
8315,s20839966,20839966,헤어교수,1,1,1,3
8316,s1550265355,1550265355,씨쓰리미용실,1,1,1,3
8317,s11729740,11729740,블루클럽 자양3동점,1,1,1,3
8318,s37448425,37448425,은수네헤어 2호점,1,1,1,3
8319,s1258967374,1258967374,진영헤어,1,1,1,3
8320,s1104926802,1104926802,헤어썸,1,1,1,3
8321,s1896289817,1896289817,청담헤어,1,1,1,3
8322,s37240829,37240829,DegaHair,1,1,1,3
8323,s13156071,13156071,양컷퍼드업헤어샵,1,1,1,3
8324,s35195012,35195012,프로포즈 헤어,1,1,1,3
8325,s11694758,11694758,헤어위드곽,1,1,1,3
8326,s34006912,34006912,사라헤어,1,1,1,3
8327,s38576403,38576403,소프레사컨셉헤어살롱 건대점,1,1,1,3
8328,s36178025,36178025,파드마헤어,1,1,1,3
8329,s1423165587,1423165587,채이헤어,1,1,1,3
8330,s1498318132,1498318132,헤어지지마,1,1,1,3
8331,s18806693,18806693,지윤헤어,1,1,1,3
8332,s18800088,18800088,미다듬헤어아트,1,1,1,3
8333,s1330449892,1330449892,민정미용실,1,1,1,3
8334,s1288641157,1288641157,보리미용실,1,1,1,3
8335,s1244499284,1244499284,러빈헤어,1,1,1,3
8336,s1956398406,1956398406,존레이먼드 바버샵,1,1,1,3
8337,s1658050701,1658050701,까까머리방,1,1,1,3
8338,s37112581,37112581,더커트클럽구로디지털점,1,1,1,3
8339,s1323010218,1323010218,누리헤어,1,1,1,3
8340,s1359803298,1359803298,조은 헤나 & 염색,1,1,1,3
8341,s108390711,108390711,180도헤어,1,1,1,3
8342,s1384931195,1384931195,한나미용실,1,1,1,3
8343,s1851300506,1851300506,빛나는날,1,1,1,3
8344,s1575005931,1575005931,보노헤어 2호점,1,1,1,3
8345,s1947027482,1947027482,이훈plan30000 롯데점,1,1,1,3
8346,s1237053171,1237053171,지에이치헤어,1,1,1,3
8347,s1645178285,1645178285,하버드미용실,1,1,1,3
8348,s1702050678,1702050678,헤어나인 신림점,1,1,1,3
8349,s1904386427,1904386427,이다헤어,1,1,1,3
8350,s20910336,20910336,성모미용실,1,1,1,3
8351,s1074271478,1074271478,ADELA HAIR,1,1,1,3
8352,s1465219085,1465219085,민이헤어,1,1,1,3
8353,s11863103,11863103,샤론헤어,1,1,1,3
8354,s1219684913,1219684913,머리향기,1,1,1,3
8355,s1225249505,1225249505,머리해샵,1,1,1,3
8356,s64242258,64242258,린다김헤어,1,1,1,3
8357,s1430175735,1430175735,개성시대,1,1,1,3
8358,s1937358257,1937358257,가위와빗헤어클럽,1,1,1,3
8359,s1644252891,1644252891,멋진하루헤어샵,1,1,1,3
8360,s1830950402,1830950402,젠틀맨,1,1,1,3
8361,s457268145,457268145,현아헤어,1,1,1,3
8362,s653106864,653106864,실크미용샵,1,1,1,3
8363,s1519816269,1519816269,스마트남성커트전문점,1,1,1,3
8364,s20856400,20856400,나영헤어미용실,1,1,1,3
8365,s20852601,20852601,엄지미용실,1,1,1,3
8366,s38269379,38269379,최쌤빠마헤어,1,1,1,3
8367,s31730036,31730036,체안지,1,1,1,3
8368,s1899912382,1899912382,235HAIR,1,1,1,3
8369,s1035644951,1035644951,용궁헤어,1,1,1,3
8370,s37829660,37829660,제니 미장원,1,1,1,3
8371,s1609201269,1609201269,미첼헤어,1,1,1,3
8372,s1403763209,1403763209,주하헤어,1,1,1,3
8373,s1834819439,1834819439,블로비,1,1,1,3
8374,s1461788127,1461788127,공간헤어,1,1,1,3
8375,s1046341510,1046341510,윤슬헤어작업실,1,1,1,3
8376,s1628948933,1628948933,하나린HAIR,1,1,1,3
8377,s1905418006,1905418006,Hair지지마,1,1,1,3
8378,s18808400,18808400,이홍주헤어클럽,1,1,1,3
8379,s1913546972,1913546972,엘리제이,1,1,1,3
8380,s13157825,13157825,헤어클릭,1,1,1,3
8381,s1091885519,1091885519,설레임헤어,1,1,1,3
8382,s36005216,36005216,헤어디자인하우스,1,1,1,3
8383,s13161209,13161209,남자의향기,1,1,1,3
8384,s37463621,37463621,패밀리헤어 봉천점,1,1,1,3
8385,s20936719,20936719,이지헤어,1,1,1,3
8386,s20108479,20108479,재키헤어,1,1,1,3
8387,s20837182,20837182,헤어샬롱모발자유,1,1,1,3
8388,s1533696347,1533696347,헤어체인지미용실,1,1,1,3
8389,s20879817,20879817,예스엔헤어갤러리,1,1,1,3
8390,s31887696,31887696,HAIR 2J SALON,1,1,1,3
8391,s1068624027,1068624027,헤어일미리,1,1,1,3
8392,s20829447,20829447,헤어피플,1,1,1,3
8393,s1361724487,1361724487,이븐헤어,1,1,1,3
8394,s859452971,859452971,천왕헤어,1,1,1,3
8395,s18710974,18710974,엔젤미용실,1,1,1,3
8396,s1044537851,1044537851,감성사이헤어,1,1,1,3
8397,s20824193,20824193,선아미용실,1,1,1,3
8398,s20943233,20943233,쎄븐미용실,1,1,1,3
8399,s1849979155,1849979155,윤윤헤어,1,1,1,3
8400,s1878286978,1878286978,나이스가이 봉천점,1,1,1,3
8401,s48996712,48996712,애드미헤어,1,1,1,3
8402,s20825506,20825506,창조헤어칼라,1,1,1,3
8403,s1058447307,1058447307,더끌림헤어,1,1,1,3
8404,s1991771229,1991771229,김철순헤어카페,1,1,1,3
8405,s1154570778,1154570778,연헤어,1,1,1,3
8406,s1086027197,1086027197,정민샵,1,1,1,3
8407,s1127013690,1127013690,성진헤어샵,1,1,1,3
8408,s1892260851,1892260851,디비아랑긴 낙성갤러리,1,1,1,3
8409,s1682126468,1682126468,세라비,1,1,1,3
8410,s1659122150,1659122150,유니헤어,1,1,1,3
8411,s1767346276,1767346276,THE 화사하게,1,1,1,3
8412,s1266724363,1266724363,스타일 샵,1,1,1,3
8413,s1061303573,1061303573,수헤어갤러리,1,1,1,3
8414,s1710564915,1710564915,스타헤어샵,1,1,1,3
8415,s1342925349,1342925349,헤어스토리,1,1,1,3
8416,s1248343685,1248343685,서현헤어,1,1,1,3
8417,s194275331,194275331,헤어갤러리,1,1,1,3
8418,s1034744715,1034744715,안나수이,1,1,1,3
8419,s365372543,365372543,소라헤어샵,1,1,1,3
8420,s327109946,327109946,지안,1,1,1,3
8421,s723785702,723785702,SJ헤어,1,1,1,3
8422,s20840005,20840005,헤어패밀리,1,1,1,3
8423,s1759051257,1759051257,샤크헤어,1,1,1,3
8424,s1029253083,1029253083,귀빈헤어뉴스,1,1,1,3
8425,s37085997,37085997,케이헤어,1,1,1,3
8426,s730848508,730848508,1층 미장원,1,1,1,3
8427,s606761726,606761726,하루 by H,1,1,1,3
8428,s956068367,956068367,시온헤어,1,1,1,3
8429,s1975686052,1975686052,라온헤어,1,1,1,3
8430,s1850772153,1850772153,까까머리방,1,1,1,3
8431,s21387839,21387839,쥬트헤어,1,1,1,3
8432,s1889235311,1889235311,봄미용실,1,1,1,3
8433,s1803776789,1803776789,정정미장,1,1,1,3
8434,s20939582,20939582,까망미용실,1,1,1,3
8435,s1078266046,1078266046,헤어숲,1,1,1,3
8436,s37796827,37796827,머릿결사랑 자양점,1,1,1,3
8437,s1154622528,1154622528,헤어데이,1,1,1,3
8438,s37815150,37815150,장미헤어스토리,1,1,1,3
8439,s1802889391,1802889391,엄마시대군자1호점,1,1,1,3
8440,s826847942,826847942,제이(J)헤어,1,1,1,3
8441,s11729735,11729735,블루클럽 구의점,1,1,1,3
8442,s1843743249,1843743249,힐링헤어,1,1,1,3
8443,s1664732582,1664732582,헤어코코,1,1,1,3
8444,s1842484725,1842484725,태후사랑 중곡동점,1,1,1,3
8445,s20901341,20901341,할로윈헤어,1,1,1,3
8446,s1504808961,1504808961,샤올,1,1,1,3
8447,s48823241,48823241,옻 안타는 천연염색,1,1,1,3
8448,s37161027,37161027,베라헤어,1,1,1,3
8449,s1415008119,1415008119,현숙헤어샵,1,1,1,3
8450,s1872891013,1872891013,누노헤어,1,1,1,3
8451,s1920281967,1920281967,수헤어샵,1,1,1,3
8452,s1663211261,1663211261,바바헤어살롱,1,1,1,3
8453,s11588752,11588752,김씨헤어,1,1,1,3
8454,s1610608408,1610608408,반하다헤어,1,1,1,3
8455,s1425026832,1425026832,하늘미용실,1,1,1,3
8456,s11387721,11387721,헤어아이콘,1,1,1,3
8457,s20909107,20909107,오투헤어갤러리,1,1,1,3
8458,s37039641,37039641,뉴스타일맨,1,1,1,3
8459,sk34312635,k34312635,박자영헤어웨어,1,1,1,3
8460,s37297031,37297031,더수자타헤어,1,1,1,3
8461,s1127101560,1127101560,머리사랑,1,1,1,3
8462,s1229369652,1229369652,브랜드헤어,1,1,1,3
8463,s1647568765,1647568765,엄미정헤어샵,1,1,1,3
8464,s13152944,13152944,헤어탐스,1,1,1,3
8465,s1493292638,1493292638,파랑노랑염색머리방,1,1,1,3
8466,s1033632526,1033632526,연서헤어샵,1,1,1,3
8467,s1843685356,1843685356,J플레이스헤어,1,1,1,3
8468,s38239167,38239167,지노헤어 아차산역점,1,1,1,3
8469,s1985682531,1985682531,도로시헤어,1,1,1,3
8470,s36898248,36898248,태후사랑 건대점,1,1,1,3
8471,s20828418,20828418,이승연헤어매직,1,1,1,3
8472,s20916808,20916808,유니나미용실,1,1,1,3
8473,s18833670,18833670,진선미헤어샵,1,1,1,3
8474,s1969628009,1969628009,매력남녀,1,1,1,3
8475,s19410233,19410233,헤어사랑,1,1,1,3
8476,s471226711,471226711,오늘도 이쁘다,1,1,1,3
8477,s1782574929,1782574929,동네미용실,1,1,1,3
8478,s1015156783,1015156783,품격헤어,1,1,1,3
8479,s36763264,36763264,Y  HAIR,1,1,1,3
8480,s1958450908,1958450908,다현헤어,1,1,1,3
8481,s736189108,736189108,토리헤어 아차산역점,1,1,1,3
8482,s1592831914,1592831914,j에비뉴헤어,1,1,1,3
8483,s1804688461,1804688461,B#,1,1,1,3
8484,s1344071006,1344071006,다인헤어,1,1,1,3
8485,s1458737226,1458737226,머리만들기,1,1,1,3
8486,s1866902764,1866902764,MJ헤어,1,1,1,3
8487,s1305735411,1305735411,헤네,1,1,1,3
8488,s1194823699,1194823699,su헤어,1,1,1,3
8489,s1361228736,1361228736,민지유헤어,1,1,1,3
8490,s20859388,20859388,헤어SS,1,1,1,3
8491,s37842515,37842515,러블리 헤어,1,1,1,3
8492,s1206235983,1206235983,마이베,1,1,1,3
8493,s38317377,38317377,아르마헤어,1,1,1,3
8494,s1567149142,1567149142,머리해라,1,1,1,3
8495,s754438640,754438640,필헤어,1,1,1,3
8496,s38549387,38549387,로프트 헤어,1,1,1,3
8497,s38780434,38780434,하늘헤어,1,1,1,3
8498,s20874729,20874729,서꽃헤어,1,1,1,3
8499,s1030907228,1030907228,홀리헤어,1,1,1,3
8500,s391250227,391250227,붙임머리 헤어by안나,1,1,1,3
8501,s218797595,218797595,THE HAAR HAIR,1,1,1,3
8502,s1147269530,1147269530,깐느헤어,1,1,1,3
8503,s1795853237,1795853237,디자인헤어,1,1,1,3
8504,s790987762,790987762,하담헤어,1,1,1,3
8505,s1178461374,1178461374,하루헤어,1,1,1,3
8506,s18009024,18009024,엘케이헤어,1,1,1,3
8507,s681712734,681712734,최영헤어,1,1,1,3
8508,s1854272109,1854272109,감동,1,1,1,3
8509,s1191366421,1191366421,이음머리공작소 건대역점,1,1,1,3
8510,s21617825,21617825,BONO,1,1,1,3
8511,s35489336,35489336,1st Style,1,1,1,3
8512,s1167317501,1167317501,어도러블헤어,1,1,1,3
8513,s1646440923,1646440923,한헤어,1,1,1,3
8514,s20866905,20866905,헤어라인,1,1,1,3
8515,s20828135,20828135,젬미용실,1,1,1,3
8516,s20885178,20885178,고은머리,1,1,1,3
8517,s1820973658,1820973658,이노헤어,1,1,1,3
8518,s31336653,31336653,가연미용실,1,1,1,3
8519,s31301334,31301334,세븐헤어샵,1,1,1,3
8520,s31863931,31863931,U2헤어,1,1,1,3
8521,s1214890821,1214890821,예가헤어,1,1,1,3
8522,s1874873686,1874873686,장현헤어,1,1,1,3
8523,s20928098,20928098,헤어카마,1,1,1,3
8524,s277185284,277185284,미소헤어,1,1,1,3
8525,s38667592,38667592,서경헤어샵,1,1,1,3
8526,s36454119,36454119,라임헤어&네일,1,1,1,3
8527,s31825753,31825753,Jenny헤어,1,1,1,3
8528,s1378788625,1378788625,러블리헤어,1,1,1,3
8529,s1940397776,1940397776,리나헤어,1,1,1,3
8530,s19407136,19407136,현지헤어코코,1,1,1,3
8531,s32548172,32548172,온리헤어,1,1,1,3
8532,s1426780681,1426780681,바비헤어,1,1,1,3
8533,s31469630,31469630,바비제이헤어,1,1,1,3
8534,s1081047726,1081047726,시리어스미용실,1,1,1,3
8535,s1493740048,1493740048,힐링헤어,1,1,1,3
8536,s1824822666,1824822666,멋지다 당신샵,1,1,1,3
8537,s20928164,20928164,K1헤어,1,1,1,3
8538,s34346694,34346694,다인헤어,1,1,1,3
8539,s1913900622,1913900622,헤어인,1,1,1,3
8540,s1274874991,1274874991,오투헤어,1,1,1,3
8541,s1606727227,1606727227,초연미용실,1,1,1,3
8542,s20819807,20819807,스타일랩,1,1,1,3
8543,s37266012,37266012,신이헤어살롱,1,1,1,3
8544,s35431637,35431637,옥머리터,1,1,1,3
8545,s20893754,20893754,춤추는가위손,1,1,1,3
8546,s1180348633,1180348633,리즈헤어,1,1,1,3
8547,s1130416273,1130416273,지은헤어,1,1,1,3
8548,s1938180222,1938180222,지은헤어 건대본점,1,1,1,3
8549,s1280260428,1280260428,지은헤어건대분점,1,1,1,3
8550,s1247891186,1247891186,머리하기좋은날,1,1,1,3
8551,s1954937604,1954937604,62HAIR,1,1,1,3
8552,s18834325,18834325,이쁜외출화양점,1,1,1,3
8553,s20843775,20843775,W헤어뷰티,1,1,1,3
8554,s1146174033,1146174033,조은주헤어,1,1,1,3
8555,s122563034,122563034,신데렐라뷰티살롱,1,1,1,3
8556,s20415533,20415533,나라헤어,1,1,1,3
8557,s31498626,31498626,튀는머리헤어,1,1,1,3
8558,s1760783274,1760783274,퀸헤어샵,1,1,1,3
8559,s1445080615,1445080615,로이헤어,1,1,1,3
8560,s1976674595,1976674595,효원헤어,1,1,1,3
8561,s20843850,20843850,유나헤어포유,1,1,1,3
8562,s20886177,20886177,임지영헤어샵,1,1,1,3
8563,s20920350,20920350,뷰티헤어라인,1,1,1,3
8564,s20847719,20847719,미스타미용실,1,1,1,3
8565,s1891702639,1891702639,미조헤어,1,1,1,3
8566,s20847732,20847732,라샹떼헤어뷰,1,1,1,3
8567,s18815416,18815416,자매헤어닷컴,1,1,1,3
8568,s18819301,18819301,스칼렛헤어,1,1,1,3
8569,s20920592,20920592,윤헤어모드,1,1,1,3
8570,s1676809921,1676809921,써니미용실,1,1,1,3
8571,s1339465099,1339465099,리우헤어살롱,1,1,1,3
8572,s20867002,20867002,수헤어,1,1,1,3
8573,s1970118231,1970118231,샤카헤어,1,1,1,3
8574,s20912758,20912758,미앤헤어,1,1,1,3
8575,s20882482,20882482,정미용실,1,1,1,3
8576,s1714024280,1714024280,홍혜리미용실,1,1,1,3
8577,s18815438,18815438,우리는프로입니다,1,1,1,3
8578,s1820474343,1820474343,헤어홀릭,1,1,1,3
8579,s20920408,20920408,신세계미용실,1,1,1,3
8580,s18820087,18820087,김나해헤어,1,1,1,3
8581,s1819707705,1819707705,헤라미용실,1,1,1,3
8582,s1543430426,1543430426,드라보헤어커플,1,1,1,3
8583,s1314161662,1314161662,라우헤어살롱,1,1,1,3
8584,s1704769279,1704769279,리헤어샵,1,1,1,3
8585,s1067833596,1067833596,LK헤어,1,1,1,3
8586,s38704454,38704454,에즈헤어라운지 구의점,1,1,1,3
8587,s37489510,37489510,안쌤헤어,1,1,1,3
8588,s33704738,33704738,준하헤어,1,1,1,3
8589,s953747776,953747776,써니미용실,1,1,1,3
8590,s34309065,34309065,앨빈헤어,1,1,1,3
8591,s1450076427,1450076427,오드리햅번  미용실,1,1,1,3
8592,s35013493,35013493,S헤어,1,1,1,3
8593,s36440891,36440891,하사미헤어,1,1,1,3
8594,s20832184,20832184,소현헤어갤러리,1,1,1,3
8595,s1925528227,1925528227,이즈헤어,1,1,1,3
8596,s35194737,35194737,휴헤어,1,1,1,3
8597,s1238435631,1238435631,미쉘,1,1,1,3
8598,s20901404,20901404,양지헤어샵,1,1,1,3
8599,s1723351834,1723351834,살롱 제이,1,1,1,3
8600,s1302599874,1302599874,쁘띠헤어,1,1,1,3
8601,s34091669,34091669,앙스헤어,1,1,1,3
8602,s1789219333,1789219333,고고헤어,1,1,1,3
8603,s13400242,13400242,이찌헤어,1,1,1,3
8604,s1581892550,1581892550,지니헤나샵,1,1,1,3
8605,s1911123742,1911123742,미쁘다쌀롱,1,1,1,3
8606,s1973319084,1973319084,제이헤어플래너,1,1,1,3
8607,s34590371,34590371,마루헤어,1,1,1,3
8608,s1424738211,1424738211,헤세드헤어 미용실,1,1,1,3
8609,s138794226,138794226,스마일리헤어스튜디오,1,1,1,3
8610,s20933018,20933018,쎄씨헤어,1,1,1,3
8611,s20925537,20925537,원헤어갤러리,1,1,1,3
8612,s18700744,18700744,아이리스헤어샵,1,1,1,3
8613,s1552945246,1552945246,품격,1,1,1,3
8614,s19381845,19381845,에코헤어,1,1,1,3
8615,s902169202,902169202,미카헤어,1,1,1,3
8616,s1428113170,1428113170,벨라헤어,1,1,1,3
8617,s1937684843,1937684843,디그니티헤어,1,1,1,3
8618,s18697579,18697579,느티나무머리방,1,1,1,3
8619,s1721744615,1721744615,이정헤어,1,1,1,3
8620,s18700611,18700611,알파미용실,1,1,1,3
8621,s35957990,35957990,헤어이베리스,1,1,1,3
8622,s18698530,18698530,윤헤어샵,1,1,1,3
8623,s20848975,20848975,모던헤어,1,1,1,3
8624,s1921379528,1921379528,헤어byMY,1,1,1,3
8625,s159157586,159157586,더컷헤어스튜디오,1,1,1,3
8626,s646731657,646731657,미래헤어샵,1,1,1,3
8627,s20883695,20883695,김경희헤어컬렉션,1,1,1,3
8628,s1375533482,1375533482,머리랑가위랑,1,1,1,3
8629,s683846920,683846920,강격숙미용실,1,1,1,3
8630,s632899264,632899264,제이헤어,1,1,1,3
8631,s1082999502,1082999502,삼성미용실,1,1,1,3
8632,s20925376,20925376,김연희헤어,1,1,1,3
8633,s18732371,18732371,은영헤어,1,1,1,3
8634,s682463864,682463864,까미헤어솔루션,1,1,1,3
8635,s1370355167,1370355167,김민헤어라인,1,1,1,3
8636,s1860047879,1860047879,김미연헤어,1,1,1,3
8637,s20914049,20914049,머리가날개,1,1,1,3
8638,s20936953,20936953,퀸미용실,1,1,1,3
8639,s18719172,18719172,르네상스헤어,1,1,1,3
8640,s18145698,18145698,더헤어샵,1,1,1,3
8641,s1757867198,1757867198,더예쁨,1,1,1,3
8642,s21341649,21341649,보노헤어,1,1,1,3
8643,s483831922,483831922,서임헤어,1,1,1,3
8644,s1570214355,1570214355,서임미용실,1,1,1,3
8645,s861935060,861935060,남현헤어샵,1,1,1,3
8646,s37430287,37430287,작은미용실,1,1,1,3
8647,s255453303,255453303,헤어뉴스,1,1,1,3
8648,s123705147,123705147,챠밍헤어,1,1,1,3
8649,s380759917,380759917,샴푸보이,1,1,1,3
8650,s1924371756,1924371756,젠틀맨,1,1,1,3
8651,s18735375,18735375,표정있는머리,1,1,1,3
8652,s1241736986,1241736986,머리사랑,1,1,1,3
8653,s1963040276,1963040276,노숙현미용실,1,1,1,3
8654,s36005214,36005214,진헤어샵,1,1,1,3
8655,s33684571,33684571,호용희헤어스타일리스트,1,1,1,3
8656,s19866051,19866051,헤어효,1,1,1,3
8657,s1754139999,1754139999,착한이용원,1,1,1,3
8658,s1952307275,1952307275,러블리헤어,1,1,1,3
8659,s13377141,13377141,살롱드루시아,1,1,1,3
8660,s13153470,13153470,박경지헤어샵,1,1,1,3
8661,s1572434611,1572434611,가이아헤어,1,1,1,3
8662,s20871950,20871950,평화미용실,1,1,1,3
8663,s1527105525,1527105525,실크헤어,1,1,1,3
8664,s1624940939,1624940939,조이헤어,1,1,1,3
8665,s1811980593,1811980593,리나헤어,1,1,1,3
8666,s20898675,20898675,홍채헤어팰리스,1,1,1,3
8667,s1993238692,1993238692,bay51,1,1,1,3
8668,s35221575,35221575,시온헤어,1,1,1,3
8669,s20917700,20917700,김유정헤어토픽,1,1,1,3
8670,s20821349,20821349,송지연헤어샵,1,1,1,3
8671,s587302999,587302999,금발헤어,1,1,1,3
8672,s53760408,53760408,행원,1,1,1,3
8673,s1319133965,1319133965,헤나머리방,1,1,1,3
8674,s20917865,20917865,헤어살롱라인미장,1,1,1,3
8675,s37117023,37117023,스테이415,1,1,1,3
8676,s18157218,18157218,산리쯔헤어 난곡점,1,1,1,3
8677,s1113991197,1113991197,폭스헤어메이크,1,1,1,3
8678,s298038636,298038636,쥬드헤어,1,1,1,3
8679,s18195496,18195496,이미지헤어,1,1,1,3
8680,s18728264,18728264,이브미용실,1,1,1,3
8681,s20837322,20837322,젠느헤어,1,1,1,3
8682,s949155250,949155250,운애헤어샵,1,1,1,3
8683,s855802408,855802408,정혜원알레이미용실,1,1,1,3
8684,s1091097578,1091097578,엘리시아,1,1,1,3
8685,s1816239134,1816239134,머리못하는집 봉천28호점,1,1,1,3
8686,s18730291,18730291,헤어뉴스,1,1,1,3
8687,s1190526053,1190526053,쌤헤어,1,1,1,3
8688,s920955186,920955186,헤어스토리,1,1,1,3
8689,s18185788,18185788,헤어닷컴,1,1,1,3
8690,s20891138,20891138,303헤어,1,1,1,3
8691,s18727746,18727746,수미미용실,1,1,1,3
8692,s20810683,20810683,신주꾸헤어 신림점,1,1,1,3
8693,s37896026,37896026,hair by the J M 난곡점,1,1,1,3
8694,s35408067,35408067,HAIR by the J M,1,1,1,3
8695,s141207397,141207397,보보스헤어,1,1,1,3
8696,s1531208399,1531208399,미르헤어,1,1,1,3
8697,s20879942,20879942,김정숙헤어샵,1,1,1,3
8698,s1688513021,1688513021,현대헤어클럽,1,1,1,3
8699,s1482738987,1482738987,두보레미용실,1,1,1,3
8700,s20883643,20883643,미림헤어샵 신림점,1,1,1,3
8701,s20902518,20902518,팅커벨,1,1,1,3
8702,s20887443,20887443,칼라헤어뱅크,1,1,1,3
8703,s11729699,11729699,블루클럽 봉천점,1,1,1,3
8704,s13156728,13156728,수헤어갤러리,1,1,1,3
8705,s13156770,13156770,준헤어크리닉,1,1,1,3
8706,s1503631711,1503631711,1004헤어필,1,1,1,3
8707,s20864215,20864215,하니미용실,1,1,1,3
8708,s20925501,20925501,조이미용실,1,1,1,3
8709,s1278614232,1278614232,댕기미용실,1,1,1,3
8710,s799135832,799135832,댕기머리헤어,1,1,1,3
8711,s20875942,20875942,문지혜미용실,1,1,1,3
8712,s1159767375,1159767375,이재옥헤어크리닉,1,1,1,3
8713,s18694978,18694978,김씨머리방,1,1,1,3
8714,s18723516,18723516,세리헤어,1,1,1,3
8715,s1204318893,1204318893,예원미용실,1,1,1,3
8716,s1585284096,1585284096,권성희헤어아트,1,1,1,3
8717,sk18170173,k18170173,미가나머리방,1,1,1,3
8718,s18730944,18730944,헤어월드,1,1,1,3
8719,s1321537650,1321537650,민정헤어샵,1,1,1,3
8720,s38272282,38272282,현헤어아트,1,1,1,3
8721,s18698169,18698169,롯데미용실,1,1,1,3
8722,s37544073,37544073,가위소리,1,1,1,3
8723,s20898879,20898879,유수아헤어샵,1,1,1,3
8724,s18203165,18203165,임순옥헤어타임,1,1,1,3
8725,s753651273,753651273,문석화 헤어라인,1,1,1,3
8726,s1664115391,1664115391,김기자미용실,1,1,1,3
8727,s20506218,20506218,신주꾸헤어,1,1,1,3
8728,s20891039,20891039,도현헤어,1,1,1,3
8729,s20848943,20848943,이현정헤어스케치,1,1,1,3
8730,s18699812,18699812,외출준비,1,1,1,3
8731,s18070121,18070121,외출준비미용실,1,1,1,3
8732,s20859456,20859456,외출준비미용실,1,1,1,3
8733,s36005264,36005264,외출준비미용실,1,1,1,3
8734,s1049552477,1049552477,강남외출준비,1,1,1,3
8735,s18719116,18719116,한주희미용실,1,1,1,3
8736,s1051993189,1051993189,에스보떼,1,1,1,3
8737,s18199945,18199945,황석민헤어아트,1,1,1,3
8738,s87566293,87566293,제이앤제이,1,1,1,3
8739,s11660614,11660614,야마노 미용실,1,1,1,3
8740,s18177493,18177493,샤론미용실,1,1,1,3
8741,s20936931,20936931,한유진헤어샵,1,1,1,3
8742,s431557724,431557724,미앤정헤어샵,1,1,1,3
8743,s20940658,20940658,임수경미용실,1,1,1,3
8744,s1679762636,1679762636,개미미용실,1,1,1,3
8745,s20871932,20871932,헤어두,1,1,1,3
8746,s1658641516,1658641516,더맨 신대방점,1,1,1,3
8747,s1829737739,1829737739,탑헤어,1,1,1,3
8748,s18712760,18712760,2002헤어숍,1,1,1,3
8749,s18705235,18705235,하나미용실,1,1,1,3
8750,s18716368,18716368,박미용실,1,1,1,3
8751,s18703581,18703581,비즈헤어 보라매점,1,1,1,3
8752,s39461521,39461521,그녀는예뻤다,1,1,1,3
8753,s36005212,36005212,노랑머리미용실,1,1,1,3
8754,s20871917,20871917,장영희헤어아트,1,1,1,3
8755,s18710897,18710897,김향순미용실,1,1,1,3
8756,s19500835,19500835,미용커플 신림3호점,1,1,1,3
8757,s18724317,18724317,미즈박미용실,1,1,1,3
8758,s36005218,36005218,김소선 헤어아트,1,1,1,3
8759,s18712724,18712724,현헤어매직,1,1,1,3
8760,s1359795161,1359795161,장계화헤어짱,1,1,1,3
8761,s11635613,11635613,블루클럽 봉천6동점,1,1,1,3
8762,s1570877383,1570877383,수정헤어샵,1,1,1,3
8763,s1380392593,1380392593,MJ헤어,1,1,1,3
8764,s12989563,12989563,심윤심헤어,1,1,1,3
8765,s1923089966,1923089966,헤어누누,1,1,1,3
8766,s1978588251,1978588251,두가이헤어,1,1,1,3
8767,s556394561,556394561,스타헤어컬러,1,1,1,3
8768,s20936783,20936783,이가희버르장머리,1,1,1,3
8769,s20875865,20875865,최영자헤어클럽,1,1,1,3
8770,s1135083947,1135083947,헤어스케치,1,1,1,3
8771,s18735273,18735273,미소헤어샵,1,1,1,3
8772,s1075411266,1075411266,리치헤어클리닉,1,1,1,3
8773,s53749884,53749884,헤어월드,1,1,1,3
8774,s272866608,272866608,하이클라스 신림점,1,1,1,3
8775,s989814214,989814214,혜원헤어크리닉,1,1,1,3
8776,s13161211,13161211,헤어크리닉 해와달,1,1,1,3
8777,s20906471,20906471,원헤어,1,1,1,3
8778,s20894861,20894861,머리풍경,1,1,1,3
8779,s33166606,33166606,비타민헤어,1,1,1,3
8780,s13430030,13430030,신데렐라,1,1,1,3
8781,s18710295,18710295,신데렐라헤어샵,1,1,1,3
8782,s18194463,18194463,리안헤어 낙성대점,1,1,1,3
8783,s1492779588,1492779588,머리하는날,1,1,1,3
8784,s571676663,571676663,푸른미용실,1,1,1,3
8785,s50932634,50932634,헤어퍼플 신림점,1,1,1,3
8786,s1818823941,1818823941,세은헤어샵,1,1,1,3
8787,s20933150,20933150,소영헤어샵,1,1,1,3
8788,s710655929,710655929,럭키미용실,1,1,1,3
8789,s18180552,18180552,1080헤어샵,1,1,1,3
8790,s1876211039,1876211039,샨헤어,1,1,1,3
8791,s938744181,938744181,프린세스,1,1,1,3
8792,s18215184,18215184,뷰티헤어,1,1,1,3
8793,s18696635,18696635,김연희머리하는집,1,1,1,3
8794,s36132245,36132245,라피네헤어,1,1,1,3
8795,s1562381177,1562381177,소연미장원,1,1,1,3
8796,s1036306153,1036306153,비젼헤어청룡점,1,1,1,3
8797,s1062706221,1062706221,수헤어,1,1,1,3
8798,s872989848,872989848,수헤어은천점,1,1,1,3
8799,s20860402,20860402,수미용실,1,1,1,3
8800,s31401092,31401092,정미용실,1,1,1,3
8801,s36827391,36827391,루아헤어&스토어 봉천점,1,1,1,3
8802,s36561480,36561480,호용희헤어 봉천점,1,1,1,3
8803,s1490975898,1490975898,헤어너나들이,1,1,1,3
8804,s131564477,131564477,S헤어샾,1,1,1,3
8805,s1477290903,1477290903,민헤어,1,1,1,3
8806,s86480220,86480220,헤어플러스미용실,1,1,1,3
8807,s1387321668,1387321668,미와끼 헤어살롱,1,1,1,3
8808,s37750018,37750018,표정있는머리,1,1,1,3
8809,s150096939,150096939,머리하는날,1,1,1,3
8810,s20894053,20894053,앤헤어샵,1,1,1,3
8811,s429954999,429954999,앤미용실,1,1,1,3
8812,s37589860,37589860,벤자민바커,1,1,1,3
8813,s1298298178,1298298178,가온헤어,1,1,1,3
8814,s1729718589,1729718589,포디씨앙,1,1,1,3
8815,s57193477,57193477,QZ헤어,1,1,1,3
8816,s36200003,36200003,오필헤어,1,1,1,3
8817,s1721051260,1721051260,희헤어,1,1,1,3
8818,s503140968,503140968,샤론헤어샵,1,1,1,3
8819,s1315561609,1315561609,은주미용실,1,1,1,3
8820,s1837530407,1837530407,은주헤어샵,1,1,1,3
8821,s36188339,36188339,미희헤어,1,1,1,3
8822,s35822781,35822781,퀸즈헤나,1,1,1,3
8823,s1531049697,1531049697,마리헤어,1,1,1,3
8824,s1761996196,1761996196,자르젠헤어,1,1,1,3
8825,s1384248963,1384248963,라채,1,1,1,3
8826,s35215604,35215604,JDS헤어디자인,1,1,1,3
8827,s18712105,18712105,헤어라떼,1,1,1,3
8828,s37824057,37824057,썬헤어,1,1,1,3
8829,s1811852985,1811852985,티아라헤어샵,1,1,1,3
8830,s20932890,20932890,쿨헤어,1,1,1,3
8831,s19923861,19923861,헤어채널,1,1,1,3
8832,s1764558783,1764558783,쎄씨헤어클럽,1,1,1,3
8833,s19993510,19993510,퀸즈헤어,1,1,1,3
8834,s36310491,36310491,앙뜨헤어,1,1,1,3
8835,s38724217,38724217,헤어코코,1,1,1,3
8836,s1912585692,1912585692,킴스헤어,1,1,1,3
8837,s38317271,38317271,헤어복순,1,1,1,3
8838,s34362848,34362848,여기서헤어,1,1,1,3
8839,s38431920,38431920,The자름헤어,1,1,1,3
8840,s887602090,887602090,엄지헤어,1,1,1,3
8841,s1933545354,1933545354,스텔라헤어,1,1,1,3
8842,s1314687307,1314687307,윤헤어샵,1,1,1,3
8843,s38737567,38737567,디자인바이권혁,1,1,1,3
8844,s30824759,30824759,리리헤어샵,1,1,1,3
8845,s519121965,519121965,이은수헤어,1,1,1,3
8846,s1495849486,1495849486,나이스가이 서울대입구점,1,1,1,3
8847,s33176963,33176963,바오헤어 신림점,1,1,1,3
8848,s532725412,532725412,반헤어,1,1,1,3
8849,s18703187,18703187,이화헤어크리닉,1,1,1,3
8850,s529507296,529507296,도도한머리,1,1,1,3
8851,s1189138829,1189138829,인정머리,1,1,1,3
8852,s447558780,447558780,보이지않는차이 3호점,1,1,1,3
8853,s1725208120,1725208120,라보떼헤어,1,1,1,3
8854,s1837243180,1837243180,엣지헤어,1,1,1,3
8855,s836256769,836256769,아르떼헤어,1,1,1,3
8856,s104931339,104931339,티파니헤어,1,1,1,3
8857,s34666487,34666487,예다나헤어,1,1,1,3
8858,s1606041620,1606041620,퍼스널헤어,1,1,1,3
8859,s847978736,847978736,헤어타이0819,1,1,1,3
8860,s296930972,296930972,티나헤어,1,1,1,3
8861,s37323312,37323312,살롱드케이,1,1,1,3
8862,s34635453,34635453,달콤한가위소리,1,1,1,3
8863,s1676140004,1676140004,아지트헤어샵,1,1,1,3
8864,s20906539,20906539,해솔헤어,1,1,1,3
8865,s35957536,35957536,두언니헤어살롱,1,1,1,3
8866,s38711392,38711392,레몬헤어,1,1,1,3
8867,s611947221,611947221,래몬헤어,1,1,1,3
8868,s37690525,37690525,셰인헤어,1,1,1,3
8869,s20902470,20902470,여기미용실,1,1,1,3
8870,s1321776641,1321776641,러블리헤어,1,1,1,3
8871,s324872346,324872346,싹헤어,1,1,1,3
8872,s38526641,38526641,더끌림헤어,1,1,1,3
8873,s37811432,37811432,진헤어,1,1,1,3
8874,s1559072192,1559072192,모델만들기 헤어샵,1,1,1,3
8875,s37699904,37699904,모노헤어,1,1,1,3
8876,s1924135874,1924135874,알렉스헤어샵,1,1,1,3
8877,s37778153,37778153,J뷰티샵,1,1,1,3
8878,s35949554,35949554,끌림헤어,1,1,1,3
8879,s219926194,219926194,오렌지헤어,1,1,1,3
8880,s36336807,36336807,구피샵 봉천현대점,1,1,1,3
8881,s659376521,659376521,두산미용실,1,1,1,3
8882,s648000253,648000253,미스터K,1,1,1,3
8883,s738769268,738769268,컷트클럽,1,1,1,3
8884,s18725680,18725680,신데렐라헤어,1,1,1,3
8885,s34358454,34358454,꼬뜰레헤어,1,1,1,3
8886,s19418685,19418685,다미헤어,1,1,1,3
8887,s20883791,20883791,조임자헤어,1,1,1,3
8888,s18724433,18724433,윤머리방,1,1,1,3
8889,s1010277046,1010277046,꽁빤니미용실,1,1,1,3
8890,s1527394710,1527394710,스타일헤어샵,1,1,1,3
8891,s20593341,20593341,아우라헤어,1,1,1,3
8892,s1858214643,1858214643,예린헤어,1,1,1,3
8893,s631410174,631410174,C&C헤어,1,1,1,3
8894,s20840979,20840979,빡빡아머리깍자,1,1,1,3
8895,s21219534,21219534,착헤어LK,1,1,1,3
8896,s1964967402,1964967402,머리나라,1,1,1,3
8897,s20852640,20852640,표정있는머리,1,1,1,3
8898,s449587861,449587861,재키헤어,1,1,1,3
8899,s18720934,18720934,라라헤어,1,1,1,3
8900,s486996702,486996702,헤어쟁이,1,1,1,3
8901,s1325190940,1325190940,정인이네미장원,1,1,1,3
8902,s31728779,31728779,아름다운헤어,1,1,1,3
8903,s1589035888,1589035888,써니헤어,1,1,1,3
8904,s31730067,31730067,샤이나헤어,1,1,1,3
8905,s1544788847,1544788847,진헤어라인,1,1,1,3
8906,s19509254,19509254,엘리스헤어,1,1,1,3
8907,s31328526,31328526,쥬헤어마스터,1,1,1,3
8908,s18712108,18712108,리치헤어,1,1,1,3
8909,s20901647,20901647,시은미용실,1,1,1,3
8910,s1209582727,1209582727,멋내기터 신림점,1,1,1,3
8911,s749865812,749865812,듀크헤어,1,1,1,3
8912,s84846697,84846697,헤라,1,1,1,3
8913,s18195480,18195480,김성화헤어아트,1,1,1,3
8914,s122684225,122684225,미쁘다헤어,1,1,1,3
8915,s1813079772,1813079772,비젼헤어,1,1,1,3
8916,s20921603,20921603,헤어리드,1,1,1,3
8917,s1473075007,1473075007,헤어라떼,1,1,1,3
8918,s18709759,18709759,헤어블랑,1,1,1,3
8919,s540818034,540818034,열린미용실,1,1,1,3
8920,s1875833690,1875833690,헤어살롱미호,1,1,1,3
8921,s20940486,20940486,헤어스토리,1,1,1,3
8922,s21341725,21341725,헤어리더미용실,1,1,1,3
8923,s34463276,34463276,라렌느헤어,1,1,1,3
8924,s1709344665,1709344665,민비미용실,1,1,1,3
8925,s37936549,37936549,수헤어,1,1,1,3
8926,s13153930,13153930,명동헤어모드,1,1,1,3
8927,s37561731,37561731,간지헤어,1,1,1,3
8928,s32302565,32302565,멋내기터,1,1,1,3
8929,s31420202,31420202,JK헤어,1,1,1,3
8930,s35228499,35228499,머리못하는집 난곡44호점,1,1,1,3
8931,s20871920,20871920,W헤어,1,1,1,3
8932,s187728139,187728139,귀거래헤어샵,1,1,1,3
8933,s11603904,11603904,머리치장,1,1,1,3
8934,s1907620722,1907620722,이훈30000미용실 당곡사거리점,1,1,1,3
8935,s1856614677,1856614677,오늘헤어,1,1,1,3
8936,s1098885385,1098885385,공감헤어,1,1,1,3
8937,s1173287279,1173287279,헤어아띠,1,1,1,3
8938,s36183984,36183984,비올렛헤어,1,1,1,3
8939,s566540934,566540934,헤어바이쥬디,1,1,1,3
8940,s455454303,455454303,마리 헤어살롱,1,1,1,3
8941,s34358691,34358691,머릿결사랑헤어,1,1,1,3
8942,s36005215,36005215,행복한미용실,1,1,1,3
8943,s18212074,18212074,궁전미용실,1,1,1,3
8944,s18724319,18724319,다모아헤어,1,1,1,3
8945,s1181776025,1181776025,공주미용실,1,1,1,3
8946,s20921466,20921466,헤어살롱B&G 서울대점,1,1,1,3
8947,s463920048,463920048,머리치장미용실,1,1,1,3
8948,s38653912,38653912,좋은느낌헤어트렌드,1,1,1,3
8949,s18728615,18728615,춤추는가위손,1,1,1,3
8950,s35878127,35878127,헤어썸,1,1,1,3
8951,s1050880386,1050880386,미사랑헤어,1,1,1,3
8952,s311757831,311757831,뉴샤론헤어샵,1,1,1,3
8953,s31400436,31400436,제이케이헤어,1,1,1,3
8954,s1292209647,1292209647,쿨헤어,1,1,1,3
8955,s960498325,960498325,누리에헤어,1,1,1,3
8956,s399164769,399164769,아는언니헤어,1,1,1,3
8957,s1481676033,1481676033,행운미장,1,1,1,3
8958,s726521304,726521304,심영희헤어,1,1,1,3
8959,s20891280,20891280,머리나라,1,1,1,3
8960,s35169118,35169118,에스더헤어,1,1,1,3
8961,s1522825138,1522825138,선녀와나무꾼,1,1,1,3
8962,s895120534,895120534,머리하는날,1,1,1,3
8963,s20894899,20894899,줌헤어아트삼성본점,1,1,1,3
8964,s18697745,18697745,머리하는날,1,1,1,3
8965,s38557676,38557676,나이스가이 신림점,1,1,1,3
8966,s38235794,38235794,결,1,1,1,3
8967,s1036440296,1036440296,착한미용실원투쓰리,1,1,1,3
8968,s774140319,774140319,로뎀헤어,1,1,1,3
8969,s650912267,650912267,라떼헤어,1,1,1,3
8970,s391383557,391383557,헤어세트,1,1,1,3
8971,s1888363319,1888363319,머리이야기헤어샵,1,1,1,3
8972,s1373105612,1373105612,머리이야기미용실,1,1,1,3
8973,s34635187,34635187,벨라지오,1,1,1,3
8974,s20928627,20928627,김미숙헤어라인,1,1,1,3
8975,s20917374,20917374,키이스미용실,1,1,1,3
8976,s1813811944,1813811944,주희미용실,1,1,1,3
8977,s196116828,196116828,블링헤어,1,1,1,3
8978,s985353430,985353430,헤어 미샵,1,1,1,3
8979,s34291811,34291811,커즈헤어살롱,1,1,1,3
8980,s570878037,570878037,뜰헤어샵,1,1,1,3
8981,s35179727,35179727,블루클럽 둔촌역점,1,1,1,3
8982,s35168881,35168881,타임헤어,1,1,1,3
8983,s21267896,21267896,김선영헤어스토리,1,1,1,3
8984,s36284042,36284042,선헤어,1,1,1,3
8985,s35202174,35202174,coco헤어,1,1,1,3
8986,s1458702735,1458702735,코코헤어,1,1,1,3
8987,s31958909,31958909,블링헤어,1,1,1,3
8988,s18609164,18609164,이숙영미용실,1,1,1,3
8989,s35432604,35432604,더에스헤어,1,1,1,3
8990,s1017337127,1017337127,티에이치헤어렙,1,1,1,3
8991,s38347212,38347212,온스타일,1,1,1,3
8992,s205044340,205044340,헤어샵끼플러스,1,1,1,3
8993,s1842780062,1842780062,샬롬헤어,1,1,1,3
8994,s792361042,792361042,스타일바이에이치,1,1,1,3
8995,s35395507,35395507,H 헤어,1,1,1,3
8996,s38415330,38415330,토리헤어 굽은다리역점,1,1,1,3
8997,s13479132,13479132,리즈헤어,1,1,1,3
8998,s174372153,174372153,벨헤어,1,1,1,3
8999,s1920957700,1920957700,스타헤어,1,1,1,3
9000,s38471795,38471795,오늘헤어,1,1,1,3
9001,s34786965,34786965,라벨르팜,1,1,1,3
9002,s11729598,11729598,블루클럽 둔촌보훈점,1,1,1,3
9003,s234755994,234755994,포인트헤어,1,1,1,3
9004,s13160593,13160593,임명수헤어밸리,1,1,1,3
9005,s1206227254,1206227254,헤어드레싱 7호점,1,1,1,3
9006,s278287200,278287200,박숙희헤어샵,1,1,1,3
9007,s1334065710,1334065710,이인영헤어플러스,1,1,1,3
9008,s1108732629,1108732629,감성미용실 라온,1,1,1,3
9009,s1456540231,1456540231,블루블루,1,1,1,3
9010,s37384032,37384032,더 제이 살롱,1,1,1,3
9011,s137635601,137635601,나리헤어샵,1,1,1,3
9012,s622282544,622282544,헤어사랑,1,1,1,3
9013,s37717693,37717693,닐로헤어,1,1,1,3
9014,s20632587,20632587,재경헤어샵,1,1,1,3
9015,s245490535,245490535,미헤어,1,1,1,3
9016,s1385429769,1385429769,빨간머리미용실,1,1,1,3
9017,s35296743,35296743,디자인 에비뉴 연,1,1,1,3
9018,s1957872819,1957872819,뉴욕헤어,1,1,1,3
9019,s984345047,984345047,늘헤어,1,1,1,3
9020,s345940226,345940226,뿔난여우헤어살롱,1,1,1,3
9021,s660613764,660613764,33끌린 헤어스튜디오,1,1,1,3
9022,s36792247,36792247,JS헤어,1,1,1,3
9023,s1431031935,1431031935,예인헤어샵,1,1,1,3
9024,s1329791581,1329791581,살롱드수,1,1,1,3
9025,s1779894351,1779894351,michaels,1,1,1,3
9026,s1631470148,1631470148,안지현헤어,1,1,1,3
9027,s36139783,36139783,봄뷰티샵,1,1,1,3
9028,s38502629,38502629,까미노헤어,1,1,1,3
9029,s1403979759,1403979759,헤어아트,1,1,1,3
9030,s1895254134,1895254134,진주헤어,1,1,1,3
9031,s1350030929,1350030929,헤어사랑,1,1,1,3
9032,s69645034,69645034,김은헤어,1,1,1,3
9033,s426932923,426932923,쟈르당헤어크리닉,1,1,1,3
9034,s1498701301,1498701301,김정란헤어,1,1,1,3
9035,s1236050015,1236050015,여우스타일미용실,1,1,1,3
9036,s36428396,36428396,아도르헤어,1,1,1,3
9037,s1111398972,1111398972,상상모리뷰티살롱,1,1,1,3
9038,s547731106,547731106,정헤어,1,1,1,3
9039,s21362053,21362053,미작,1,1,1,3
9040,s20632409,20632409,헤어BELLE,1,1,1,3
9041,s18918812,18918812,핸썸가이암사본점,1,1,1,3
9042,s36797933,36797933,심쿵미용실,1,1,1,3
9043,s866517873,866517873,쉬즈헤어,1,1,1,3
9044,s812997353,812997353,헤어레브,1,1,1,3
9045,s989688373,989688373,영헤어,1,1,1,3
9046,s1766553385,1766553385,헤어아뜰리에by지니,1,1,1,3
9047,s37800452,37800452,오땡큐 길동점,1,1,1,3
9048,s1807541222,1807541222,헤어J,1,1,1,3
9049,s1279271429,1279271429,더 두레 헤어,1,1,1,3
9050,s1224787831,1224787831,보그헤어,1,1,1,3
9051,s18578036,18578036,헤어장,1,1,1,3
9052,s1455004518,1455004518,나이스헤어,1,1,1,3
9053,s18892760,18892760,나드리미용실,1,1,1,3
9054,s1381793850,1381793850,은혜미용실,1,1,1,3
9055,s1488783554,1488783554,공행자헤어,1,1,1,3
9056,s18892416,18892416,정원헤어,1,1,1,3
9057,s1053170093,1053170093,전영미용실,1,1,1,3
9058,s1161495592,1161495592,아름다운헤어,1,1,1,3
9059,s1147911886,1147911886,샤롯트 헤어클리닉,1,1,1,3
9060,s18892680,18892680,씨에프헤어,1,1,1,3
9061,s1705180055,1705180055,바이윤 헤어,1,1,1,3
9062,s1211592620,1211592620,예림헤어,1,1,1,3
9063,s769786609,769786609,우리헤어,1,1,1,3
9064,s1814657873,1814657873,머리못하는집,1,1,1,3
9065,s38507477,38507477,씨엘헤어,1,1,1,3
9066,s20624389,20624389,크리애헤어,1,1,1,3
9067,s21892568,21892568,상일헤어월드,1,1,1,3
9068,s18585411,18585411,댕기머리방,1,1,1,3
9069,s1075280090,1075280090,슈브헤어랜드,1,1,1,3
9070,s18912393,18912393,더헤어,1,1,1,3
9071,s1285204540,1285204540,이훈ALL30000 명일점,1,1,1,3
9072,s1136792610,1136792610,머리말아좋은날,1,1,1,3
9073,s628184878,628184878,깍까머리방,1,1,1,3
9074,s1912642710,1912642710,샬롱드현주,1,1,1,3
9075,s1095083117,1095083117,살롱드블랑헤어,1,1,1,3
9076,s1103032101,1103032101,라라살롱,1,1,1,3
9077,s1151909483,1151909483,윰헤어,1,1,1,3
9078,s1189374996,1189374996,헤어센스,1,1,1,3
9079,s1476368371,1476368371,리코헤어,1,1,1,3
9080,s1153916747,1153916747,M헤어,1,1,1,3
9081,s1259232919,1259232919,봉수아헤어,1,1,1,3
9082,s1320022967,1320022967,블루&블루,1,1,1,3
9083,s19378972,19378972,주연미용실,1,1,1,3
9084,s32839533,32839533,김경임 HairShop,1,1,1,3
9085,s684694234,684694234,제이헤어필,1,1,1,3
9086,s1304519930,1304519930,엣지헤어,1,1,1,3
9087,s1028788371,1028788371,더샤인헤어,1,1,1,3
9088,s739446013,739446013,쥬니헤어,1,1,1,3
9089,s32114776,32114776,더좋은날,1,1,1,3
9090,s20626969,20626969,이수빈헤어코너,1,1,1,3
9091,s18617508,18617508,전경화머리나라,1,1,1,3
9092,s21791411,21791411,아가페헤어,1,1,1,3
9093,s1021698333,1021698333,헤어바비,1,1,1,3
9094,s37562113,37562113,연이아뜰리에,1,1,1,3
9095,s1664861277,1664861277,서희헤어스튜디오,1,1,1,3
9096,s18915793,18915793,머리하는날,1,1,1,3
9097,s1261351548,1261351548,hee헤어,1,1,1,3
9098,s1699398486,1699398486,미용실 by 우리,1,1,1,3
9099,s36669033,36669033,땡큐베리머리,1,1,1,3
9100,s335005446,335005446,헤어스케치,1,1,1,3
9101,s36907338,36907338,아쿠아헤어,1,1,1,3
9102,s18910783,18910783,신데렐라,1,1,1,3
9103,s1096956643,1096956643,임청하헤어원,1,1,1,3
9104,s1492242326,1492242326,에브리데이이즈뉴,1,1,1,3
9105,s298286360,298286360,영동헤어,1,1,1,3
9106,s1983459107,1983459107,로사헤어스토리,1,1,1,3
9107,s32865719,32865719,앤와이미용실,1,1,1,3
9108,s18658593,18658593,유선희미용실,1,1,1,3
9109,s18916525,18916525,장미미용실,1,1,1,3
9110,s1204762477,1204762477,예쁜여우,1,1,1,3
9111,s1798799031,1798799031,쿠잉헤어,1,1,1,3
9112,s658480151,658480151,김은희구뜨,1,1,1,3
9113,s1160042019,1160042019,헤어디자이너 소라 헤어샵,1,1,1,3
9114,s641290259,641290259,헤어바라기,1,1,1,3
9115,s1757679531,1757679531,엘리사벳헤어샵,1,1,1,3
9116,s1612662314,1612662314,윤헤어갤러리,1,1,1,3
9117,s18914734,18914734,헤어리더,1,1,1,3
9118,s1239838227,1239838227,루디아헤어샵,1,1,1,3
9119,s13227005,13227005,클라라 헤어,1,1,1,3
9120,s1068092462,1068092462,나무헤어,1,1,1,3
9121,s1678178079,1678178079,헤어씨엘,1,1,1,3
9122,s1285268090,1285268090,차지윤미장원,1,1,1,3
9123,s768420050,768420050,윤비헤어,1,1,1,3
9124,s1753612888,1753612888,현머리방,1,1,1,3
9125,s920029860,920029860,헤어짱미용실,1,1,1,3
9126,s30848193,30848193,헤라헤어,1,1,1,3
9127,s20634721,20634721,아녜스헤어,1,1,1,3
9128,s34807713,34807713,이지헤어,1,1,1,3
9129,s35554143,35554143,s뷰티클레스,1,1,1,3
9130,s624716016,624716016,미인미남,1,1,1,3
9131,s990775869,990775869,쉬크헤어,1,1,1,3
9132,s20634751,20634751,아우라헤어,1,1,1,3
9133,s1177830577,1177830577,뷰티헤어,1,1,1,3
9134,s224391132,224391132,행복한날헤어,1,1,1,3
9135,s20642949,20642949,뮤즈헤어,1,1,1,3
9136,s36998119,36998119,청담하우스헤어,1,1,1,3
9137,s53632551,53632551,후리지아미용실,1,1,1,3
9138,s1642032092,1642032092,화이트헤어,1,1,1,3
9139,s1998371413,1998371413,원정민헤어,1,1,1,3
9140,s1225486296,1225486296,개성시대,1,1,1,3
9141,s20632278,20632278,손지영미용실,1,1,1,3
9142,s18898871,18898871,현헤어스케치,1,1,1,3
9143,s887842804,887842804,보떼헤어,1,1,1,3
9144,s956697276,956697276,정아헤어,1,1,1,3
9145,s13157613,13157613,미남,1,1,1,3
9146,s20622007,20622007,영헤어커커,1,1,1,3
9147,s18595672,18595672,안옥순 미용실,1,1,1,3
9148,s489584213,489584213,뷰티헤어샵,1,1,1,3
9149,s18893491,18893491,제일머리마당,1,1,1,3
9150,s87256326,87256326,최정희헤어,1,1,1,3
9151,s18910727,18910727,미스터미용실,1,1,1,3
9152,s1912029035,1912029035,키헤어,1,1,1,3
9153,s18629621,18629621,두띠헤어,1,1,1,3
9154,s13412541,13412541,느낌표헤어 본점,1,1,1,3
9155,s433868839,433868839,류구헤어,1,1,1,3
9156,s1099036749,1099036749,래미안헤어,1,1,1,3
9157,s1625189677,1625189677,이엠헤어,1,1,1,3
9158,s731098226,731098226,원정민헤어숍,1,1,1,3
9159,s1388229870,1388229870,HD마틴,1,1,1,3
9160,s1829880475,1829880475,파마헤어,1,1,1,3
9161,s11729603,11729603,블루클럽 명일점,1,1,1,3
9162,s1224683644,1224683644,가미노케헤어,1,1,1,3
9163,s1489288763,1489288763,B.L헤어,1,1,1,3
9164,s1415942176,1415942176,비엘헤어,1,1,1,3
9165,s1675686935,1675686935,수연에비뉴헤어,1,1,1,3
9166,s1852264679,1852264679,스타일헤어샵,1,1,1,3
9167,s18918760,18918760,한마음미용실,1,1,1,3
9168,s1199261614,1199261614,정옥주 미용실,1,1,1,3
9169,s252360695,252360695,헤어아트박스,1,1,1,3
9170,sk1907903400,k1907903400,로이최헤어,1,1,1,3
9171,s1241588319,1241588319,제이헤어,1,1,1,3
9172,s13160957,13160957,헤어크리에이션,1,1,1,3
9173,s1169249026,1169249026,헤어까끼,1,1,1,3
9174,s33279842,33279842,구피샵 길동점,1,1,1,3
9175,s1191946756,1191946756,달곰헤어,1,1,1,3
9176,s20621311,20621311,스타일헤어,1,1,1,3
9177,s1006646671,1006646671,지니헤어,1,1,1,3
9178,s1148016450,1148016450,헤어살롱 꾸미다,1,1,1,3
9179,s482494371,482494371,팰리스헤어,1,1,1,3
9180,s1499527001,1499527001,헤어민,1,1,1,3
9181,s13156796,13156796,헤어스토리,1,1,1,3
9182,s11669493,11669493,정아헤어라인,1,1,1,3
9183,s1920308122,1920308122,헤어1983,1,1,1,3
9184,s36305490,36305490,쉘부르헤어샵,1,1,1,3
9185,s1794127072,1794127072,HAIR 720,1,1,1,3
9186,s1022259846,1022259846,현대미용실,1,1,1,3
9187,s1968492625,1968492625,317미장원,1,1,1,3
9188,s1333379631,1333379631,또봄헤어,1,1,1,3
9189,s1082772793,1082772793,한나애헤어스토리,1,1,1,3
9190,s1354034252,1354034252,바이설,1,1,1,3
9191,s404026314,404026314,금실미용실,1,1,1,3
9192,s1161711629,1161711629,살롱드에비뉴 둔촌점,1,1,1,3
9193,s20632544,20632544,벨라미용실,1,1,1,3
9194,s20621329,20621329,젤리헤어,1,1,1,3
9195,s1408149075,1408149075,준헤어,1,1,1,3
9196,s10989571,10989571,모모헤어살롱,1,1,1,3
9197,s1306615786,1306615786,머리까끼미용실,1,1,1,3
9198,s18898831,18898831,권헤어라인,1,1,1,3
9199,s1181754176,1181754176,Y헤어샵,1,1,1,3
9200,s1005928865,1005928865,로즈헤어,1,1,1,3
9201,s240734408,240734408,단골헤어,1,1,1,3
9202,s1320899351,1320899351,멜리사헤어,1,1,1,3
9203,s560990465,560990465,바운스헤어,1,1,1,3
9204,s214512221,214512221,M&S 헤어살롱,1,1,1,3
9205,s1275264569,1275264569,정이헤어,1,1,1,3
9206,s1034824241,1034824241,5헤어,1,1,1,3
9207,s1530619711,1530619711,나이스가이 강일점,1,1,1,3
9208,s1365739018,1365739018,살롱 드 린다,1,1,1,3
9209,s1411509533,1411509533,보나헤어,1,1,1,3
9210,s1259696446,1259696446,민호헤어,1,1,1,3
9211,s1482831670,1482831670,헤어바이반룬하우트 강동구청역점,1,1,1,3
9212,s1096066562,1096066562,빛나는,1,1,1,3
9213,s1277848293,1277848293,헤어염색 홍,1,1,1,3
9214,s1978434246,1978434246,지니헤어,1,1,1,3
9215,s1207737272,1207737272,봄썬헤어샵,1,1,1,3
9216,s1450522072,1450522072,당신이 머무는 곳 헤어샵,1,1,1,3
9217,s1135942826,1135942826,일호살롱,1,1,1,3
9218,s20640333,20640333,쵸콜렛미용실,1,1,1,3
9219,s667793811,667793811,둘이헤어클리닉,1,1,1,3
9220,s34329371,34329371,라라샵,1,1,1,3
9221,s1302057048,1302057048,고은미용실,1,1,1,3
9222,s1783012673,1783012673,청담살롱,1,1,1,3
9223,s1302493493,1302493493,진진헤어,1,1,1,3
9224,s18604058,18604058,헬로펌헤어,1,1,1,3
9225,s1078062703,1078062703,컬리커티미용실,1,1,1,3
9226,s17947674,17947674,신진미용실,1,1,1,3
9227,s38753110,38753110,시정미용실,1,1,1,3
9228,s1427736184,1427736184,힐링헤어J,1,1,1,3
9229,s1762365559,1762365559,윤스헤어,1,1,1,3
9230,s18918576,18918576,아인헤어,1,1,1,3
9231,s1223159545,1223159545,나이스가이 고덕그라시움점,1,1,1,3
9232,s1265060706,1265060706,헤어두,1,1,1,3
9233,s20644301,20644301,윤정미용실,1,1,1,3
9234,s562841053,562841053,안젤라미용실,1,1,1,3
9235,s1480216326,1480216326,백조미용실,1,1,1,3
9236,s314586352,314586352,마샬헤어,1,1,1,3
9237,s18922143,18922143,아가페미용실,1,1,1,3
9238,s18923994,18923994,수연미용실,1,1,1,3
9239,s18924496,18924496,샘물153,1,1,1,3
9240,s1833433871,1833433871,예잘헤어샵,1,1,1,3
9241,s38571716,38571716,미소안헤어 둔촌본점,1,1,1,3
9242,s1808353302,1808353302,라인헤어,1,1,1,3
9243,s1727303046,1727303046,오땡큐 명일점,1,1,1,3
9244,s1661418101,1661418101,라봄헤어,1,1,1,3
9245,s37086082,37086082,금발머리,1,1,1,3
9246,s1304902592,1304902592,플러스맨,1,1,1,3
9247,s1009432002,1009432002,헤나마당,1,1,1,3
9248,s1313534468,1313534468,스타일미용실,1,1,1,3
9249,s633997567,633997567,온헤어스튜디오,1,1,1,3
9250,s1421695245,1421695245,헤어하우스 가온,1,1,1,3
9251,s1339978555,1339978555,오땡큐 성내점,1,1,1,3
9252,s1439547537,1439547537,구피샵 둔촌점,1,1,1,3
9253,s37792572,37792572,헤어에비뉴,1,1,1,3
9254,s1996890792,1996890792,수염색방,1,1,1,3
9255,s1924181970,1924181970,죠쌤헤어,1,1,1,3
9256,s977850074,977850074,이지센헤어,1,1,1,3
9257,s673563622,673563622,DD미용실,1,1,1,3
9258,s992748253,992748253,리아네미장원,1,1,1,3
9259,s31730152,31730152,스케치헤어,1,1,1,3
9260,s833257421,833257421,헤어스케치,1,1,1,3
9261,s38718182,38718182,지우헤어,1,1,1,3
9262,s18920781,18920781,헤어짱,1,1,1,3
9263,s74168826,74168826,마루헤어,1,1,1,3
9264,s1819093655,1819093655,샤론헤어,1,1,1,3
9265,s37532507,37532507,브라운시저스,1,1,1,3
9266,s37677602,37677602,머리하는소년,1,1,1,3
9267,s453717150,453717150,이화영헤어,1,1,1,3
9268,s1368481830,1368481830,S헤어,1,1,1,3
9269,s37900165,37900165,헤어씨엘,1,1,1,3
9270,s1003886509,1003886509,현미용실,1,1,1,3
9271,s246658557,246658557,행복헤어,1,1,1,3
9272,s37842368,37842368,디바 에스티 헤어,1,1,1,3
9273,s38300601,38300601,모노폴리헤어,1,1,1,3
9274,s1797904392,1797904392,헤어바이 윤,1,1,1,3
9275,s18575489,18575489,미모리카락,1,1,1,3
9276,s38302472,38302472,김연민헤어,1,1,1,3
9277,s18644850,18644850,이현미헤어,1,1,1,3
9278,s32115158,32115158,NY헤어,1,1,1,3
9279,s11729582,11729582,블루클럽 굽은다리역점,1,1,1,3
9280,s264643715,264643715,헤어스토리,1,1,1,3
9281,s1284271556,1284271556,늘솜헤어,1,1,1,3
9282,s1377336608,1377336608,아리헤어,1,1,1,3
9283,s38642714,38642714,이오뷰티헤어,1,1,1,3
9284,s20641776,20641776,남정네헤어,1,1,1,3
9285,s18650718,18650718,윤애숙헤어,1,1,1,3
9286,s34678408,34678408,가미기리,1,1,1,3
9287,s18629625,18629625,베스트헤어,1,1,1,3
9288,s1059548841,1059548841,굿맨클럽 굽은다리점,1,1,1,3
9289,s13159483,13159483,김영희헤어,1,1,1,3
9290,s240247678,240247678,김경헤어칼라,1,1,1,3
9291,s863442757,863442757,현대미용실,1,1,1,3
9292,s1030426212,1030426212,클레망헤어,1,1,1,3
9293,s1602185554,1602185554,박미숙헤어,1,1,1,3
9294,s964021616,964021616,헤어M클럽,1,1,1,3
9295,s938793685,938793685,이삭헤어샾,1,1,1,3
9296,s18921912,18921912,헤어크리닉,1,1,1,3
9297,s90704079,90704079,미용실헤어스케치,1,1,1,3
9298,s1840510466,1840510466,시크헤어,1,1,1,3
9299,s1745361244,1745361244,포도쉬즈모 암사점,1,1,1,3
9300,s318234902,318234902,헬로우컷 강동역점,1,1,1,3
9301,s18918511,18918511,퓨어헤어,1,1,1,3
9302,s1067094006,1067094006,원미용실,1,1,1,3
9303,s943060262,943060262,살롱드나니,1,1,1,3
9304,s469675660,469675660,헤어스타,1,1,1,3
9305,s721568500,721568500,오은미용실,1,1,1,3
9306,s35438877,35438877,블루클럽 상일동역점,1,1,1,3
9307,s1759496323,1759496323,TOM&JERRY,1,1,1,3
9308,s1440712481,1440712481,에스헤어,1,1,1,3
9309,s1200924503,1200924503,에슐리헤어,1,1,1,3
9310,s789557104,789557104,에벤에셀헤어,1,1,1,3
9311,s1204840981,1204840981,오땡큐 둔촌점,1,1,1,3
9312,s1435398918,1435398918,오땡큐 둔촌점,1,1,1,3
9313,s1007095313,1007095313,고덕김송정머리터,1,1,1,3
9314,s36558066,36558066,김수현헤어,1,1,1,3
9315,s1346870828,1346870828,언니네헤어,1,1,1,3
9316,s1377026135,1377026135,라온마리헤어,1,1,1,3
9317,s925216219,925216219,태후사랑 고덕1호점,1,1,1,3
9318,s1697658991,1697658991,헤어공방,1,1,1,3
9319,s74554381,74554381,마론헤어,1,1,1,3
9320,s1285181882,1285181882,이움헤어,1,1,1,3
9321,s1148426646,1148426646,도도헤어,1,1,1,3
9322,s37926582,37926582,살롱드안,1,1,1,3
9323,s13160968,13160968,허해숙미용실,1,1,1,3
9324,s37913953,37913953,헤어바이시리,1,1,1,3
9325,s38248389,38248389,까망헤어,1,1,1,3
9326,s35152736,35152736,W헤어,1,1,1,3
9327,s38696541,38696541,Nadia hair,1,1,1,3
9328,s38251593,38251593,구피샵 암사점,1,1,1,3
9329,s1241479227,1241479227,미모헤어샵,1,1,1,3
9330,s38322781,38322781,MINSALON,1,1,1,3
9331,s266008615,266008615,투맨투,1,1,1,3
9332,s141824945,141824945,란미용실,1,1,1,3
9333,s980406378,980406378,써니헤어,1,1,1,3
9334,s1889144794,1889144794,남성헤어컷7000,1,1,1,3
9335,s18577452,18577452,블루클럽 고덕점,1,1,1,3
9336,s930759736,930759736,율리헤어,1,1,1,3
9337,s34353822,34353822,태후사랑 둔촌점,1,1,1,3
9338,s869457130,869457130,구피샵 명일점,1,1,1,3
9339,s1815629818,1815629818,오엘헤어,1,1,1,3
9340,s349537168,349537168,유미헤어,1,1,1,3
9341,s415588174,415588174,JW헤어,1,1,1,3
9342,s1273477815,1273477815,젤라헤어,1,1,1,3
9343,s18909815,18909815,미첼헤어,1,1,1,3
9344,s1111141997,1111141997,원앤원미용실,1,1,1,3
9345,s82908473,82908473,엘라헤어,1,1,1,3
9346,s1834294866,1834294866,헤어스토리,1,1,1,3
9347,s37286483,37286483,SOHO by LIM,1,1,1,3
9348,s35044825,35044825,주니헤어,1,1,1,3
9349,s35215651,35215651,도도붙임머리,1,1,1,3
9350,s1986902051,1986902051,강수진헤어,1,1,1,3
9351,s35366060,35366060,오다헤어 대치점,1,1,1,3
9352,s13150249,13150249,댕기머리크라시바헤어,1,1,1,3
9353,s35288588,35288588,프라브헤어살롱,1,1,1,3
9354,s1328026754,1328026754,권홍헤어 by jacob,1,1,1,3
9355,s35346873,35346873,우인뷰티살롱,1,1,1,3
9356,s1128836395,1128836395,헤어랑,1,1,1,3
9357,s1449526076,1449526076,또헤어,1,1,1,3
9358,sk1101200669,k1101200669,메모리아,1,1,1,3
9359,s1038619662,1038619662,메모리아헤어,1,1,1,3
9360,s35593368,35593368,b cut hair shop,1,1,1,3
9361,s548754619,548754619,비단헤어,1,1,1,3
9362,s35678602,35678602,르씨엘,1,1,1,3
9363,s36040090,36040090,헤어홀릭,1,1,1,3
9364,s1454315908,1454315908,아프로디테,1,1,1,3
9365,s1514845456,1514845456,준헤어살롱,1,1,1,3
9366,s1842540635,1842540635,언니네리발소,1,1,1,3
9367,s427465441,427465441,민스타일헤어살롱,1,1,1,3
9368,s1771154300,1771154300,미장원이,1,1,1,3
9369,s13150193,13150193,헤어투데이,1,1,1,3
9370,s543553754,543553754,프리미엄헤어다이스,1,1,1,3
9371,s30852812,30852812,리본헤어샵,1,1,1,3
9372,s18440914,18440914,이계숙미용실,1,1,1,3
9373,s38547364,38547364,지유,1,1,1,3
9374,s1843311328,1843311328,앤네일,1,1,1,3
9375,s34550963,34550963,포레스트,1,1,1,3
9376,s36271091,36271091,위민헤어,1,1,1,3
9377,s62205523,62205523,베스카미용실,1,1,1,3
9378,s1173587711,1173587711,엘린헤어,1,1,1,3
9379,s520873471,520873471,피렌체헤어샵,1,1,1,3
9380,s870235813,870235813,새로운헤어스타일,1,1,1,3
9381,s34119461,34119461,에이그로우,1,1,1,3
9382,s1730102865,1730102865,백전백승헤어인,1,1,1,3
9383,s18574187,18574187,드김현서헤어,1,1,1,3
9384,s33834687,33834687,애니헤어,1,1,1,3
9385,s35553026,35553026,서희헤어컬처,1,1,1,3
9386,s1179685463,1179685463,살롱케이,1,1,1,3
9387,s35117904,35117904,MUEL,1,1,1,3
9388,s616503673,616503673,뮤엘헤어,1,1,1,3
9389,s1064805371,1064805371,BARO 헤어,1,1,1,3
9390,s36561478,36561478,김수현헤어,1,1,1,3
9391,s1884058523,1884058523,데오로헤어,1,1,1,3
9392,s37467972,37467972,헤어채플린,1,1,1,3
9393,s1403337638,1403337638,로뎀헤어,1,1,1,3
9394,s1588863385,1588863385,로뎀헤어 역삼점,1,1,1,3
9395,s37620854,37620854,아이벨르팜므 대치점,1,1,1,3
9396,s38676668,38676668,더윤헤어,1,1,1,3
9397,s1669084278,1669084278,언니네미장원,1,1,1,3
9398,s37822140,37822140,리엔헤어샵,1,1,1,3
9399,s1322934663,1322934663,최고헤어,1,1,1,3
9400,s37896485,37896485,호유헤어,1,1,1,3
9401,s1281350726,1281350726,착한미용실,1,1,1,3
9402,s37910488,37910488,제이더블유앤투헤어,1,1,1,3
9403,s1207132009,1207132009,라온헤어,1,1,1,3
9404,s1918615626,1918615626,라온하임,1,1,1,3
9405,s96113777,96113777,단발머리헤어,1,1,1,3
9406,s38281230,38281230,대청헤어염색방,1,1,1,3
9407,s240870594,240870594,by감동,1,1,1,3
9408,s1006797825,1006797825,FAME 진 헤어,1,1,1,3
9409,s49107511,49107511,사랑해미용실,1,1,1,3
9410,s234030750,234030750,더청담헤어,1,1,1,3
9411,s1657716413,1657716413,더톡,1,1,1,3
9412,s1973644862,1973644862,고수에리카헤어,1,1,1,3
9413,s1189110085,1189110085,벨르수이,1,1,1,3
9414,s20900836,20900836,라성헤어,1,1,1,3
9415,s13150510,13150510,티파니헤어,1,1,1,3
9416,s36112548,36112548,살롱드윤,1,1,1,3
9417,s20858794,20858794,닥터큐헤어샵,1,1,1,3
9418,s37495575,37495575,HOME HAIR,1,1,1,3
9419,s1519315614,1519315614,오투헤어,1,1,1,3
9420,s36351266,36351266,가온헤어,1,1,1,3
9421,s1972451841,1972451841,헤나클리닉,1,1,1,3
9422,s34466132,34466132,코코헤어,1,1,1,3
9423,s21621909,21621909,소유미용실,1,1,1,3
9424,s770106318,770106318,소유헤어&메이크업,1,1,1,3
9425,s37769709,37769709,R&H 헤어,1,1,1,3
9426,s659978155,659978155,알앤에이치헤어,1,1,1,3
9427,s36823228,36823228,컬렉션위드챨리정,1,1,1,3
9428,s37633011,37633011,j헤어살롱,1,1,1,3
9429,s34357448,34357448,블루클럽 역삼점,1,1,1,3
9430,s232631602,232631602,헤어망고 대치점,1,1,1,3
9431,s11554085,11554085,헤드마스터,1,1,1,3
9432,s37039613,37039613,헤어그곳,1,1,1,3
9433,s916258236,916258236,미스터클럽,1,1,1,3
9434,s37233208,37233208,노아콤마에스,1,1,1,3
9435,s33251822,33251822,아자리아청담점,1,1,1,3
9436,s1445275975,1445275975,착한가격헤어,1,1,1,3
9437,s333591401,333591401,나미살롱,1,1,1,3
9438,s710536466,710536466,미스터헤어,1,1,1,3
9439,s1076766708,1076766708,김지후헤어갤러리,1,1,1,3
9440,s1608609322,1608609322,스타스살롱,1,1,1,3
9441,s21783500,21783500,헤어라떼,1,1,1,3
9442,s20634374,20634374,DD헤어,1,1,1,3
9443,s408671002,408671002,민 왁싱,1,1,1,3
9444,s1326456035,1326456035,제이어반터치,1,1,1,3
9445,s934732941,934732941,더맨헤어,1,1,1,3
9446,s1317257270,1317257270,초이브로우,1,1,1,3
9447,s1938614944,1938614944,엘린뷰티랩,1,1,1,3
9448,s20827780,20827780,로얄헤어샵,1,1,1,3
9449,s19969811,19969811,TAEKKIM,1,1,1,3
9450,s249878237,249878237,하루앤노아,1,1,1,3
9451,s1880086987,1880086987,가희헤어,1,1,1,3
9452,s1135633104,1135633104,헤어지지마,1,1,1,3
9453,s20377102,20377102,발렌타인,1,1,1,3
9454,sk1562814088,k1562814088,쎄미헤어,1,1,1,3
9455,s1005875309,1005875309,미스터남성커트전문점,1,1,1,3
9456,s1232285524,1232285524,장한나헤어,1,1,1,3
9457,s21061216,21061216,예올,1,1,1,3
9458,s13154039,13154039,헤어갤러리,1,1,1,3
9459,s13151245,13151245,나인테라피미용실,1,1,1,3
9460,s1294273370,1294273370,민미경헤어,1,1,1,3
9461,s19994363,19994363,칼리아헤어,1,1,1,3
9462,s18431392,18431392,헤어인러브,1,1,1,3
9463,s697084146,697084146,아나스타일,1,1,1,3
9464,s1044020547,1044020547,미앤미헤어살롱,1,1,1,3
9465,s18840116,18840116,S헤어1호점,1,1,1,3
9466,s1095251122,1095251122,에스헤어,1,1,1,3
9467,s754969870,754969870,에스블랙,1,1,1,3
9468,s32260618,32260618,위즈인헤어,1,1,1,3
9469,s93418945,93418945,쉔부른헤어살롱,1,1,1,3
9470,s1381141756,1381141756,유은정헤어,1,1,1,3
9471,s18807058,18807058,JOSHUA,1,1,1,3
9472,s38291418,38291418,로뎀헤어,1,1,1,3
9473,s935307551,935307551,벨르팜므헤어살롱,1,1,1,3
9474,s18839949,18839949,갤러리헤어,1,1,1,3
9475,s20634400,20634400,윤헤어클럽,1,1,1,3
9476,s18826661,18826661,헤어코디,1,1,1,3
9477,s20897847,20897847,청담헤어스튜디오,1,1,1,3
9478,s1006574115,1006574115,차지윤미용실,1,1,1,3
9479,s522321180,522321180,써티헤어,1,1,1,3
9480,s20889577,20889577,킴스헤어,1,1,1,3
9481,s20643232,20643232,원미용실,1,1,1,3
9482,s37269046,37269046,모트헤어,1,1,1,3
9483,s32349630,32349630,수미헤어,1,1,1,3
9484,s1236017479,1236017479,아트헤어,1,1,1,3
9485,s1439651720,1439651720,톤 헤어스튜디오,1,1,1,3
9486,s1650123643,1650123643,라이온헤어1,1,1,1,3
9487,s12011603,12011603,헤어뉴스,1,1,1,3
9488,s36505210,36505210,아슬란헤어,1,1,1,3
9489,s11858131,11858131,하안미용실,1,1,1,3
9490,s13161388,13161388,최봉관프로헤어,1,1,1,3
9491,s1495534262,1495534262,수빈헤어&메이크업,1,1,1,3
9492,s1355159765,1355159765,이끌,1,1,1,3
9493,sk1471613518,k1471613518,팀바이블룸,1,1,1,3
9494,s18486787,18486787,베르쥬반스,1,1,1,3
9495,s1768453373,1768453373,정현정 parapam,1,1,1,3
9496,s1639885374,1639885374,오색단장,1,1,1,3
9497,s36262993,36262993,라뮤제,1,1,1,3
9498,s36154403,36154403,행쇼를합시다,1,1,1,3
9499,s13161353,13161353,노승만헤어본,1,1,1,3
9500,s36160589,36160589,에스살롱나인,1,1,1,3
9501,s20866408,20866408,규리헤어,1,1,1,3
9502,s1197245786,1197245786,조경애 헤어픽스,1,1,1,3
9503,s1456520081,1456520081,세곡푸르지오미헤어드림,1,1,1,3
9504,s37298677,37298677,박철헤어살롱박철본점,1,1,1,3
9505,s1739188050,1739188050,오늘염색헤어,1,1,1,3
9506,s36166714,36166714,에스뿌아헤어,1,1,1,3
9507,s32262299,32262299,신혜리헤어스타,1,1,1,3
9508,s1820055997,1820055997,에끌라,1,1,1,3
9509,s1659743131,1659743131,헤어플레이스,1,1,1,3
9510,s604350412,604350412,헤어마지코,1,1,1,3
9511,s21613054,21613054,더샵헤어,1,1,1,3
9512,s33039823,33039823,스타일비 미용실,1,1,1,3
9513,s31021384,31021384,W헤어 대치점,1,1,1,3
9514,s18449668,18449668,헤어바이러스,1,1,1,3
9515,s21086238,21086238,블링블링뷰티샵,1,1,1,3
9516,s11858693,11858693,바비헤어,1,1,1,3
9517,s18817210,18817210,손끝차이,1,1,1,3
9518,s20596750,20596750,바버스,1,1,1,3
9519,s20942756,20942756,파라다이스,1,1,1,3
9520,s1498788228,1498788228,슈풍크헤어,1,1,1,3
9521,s37849674,37849674,헤어존,1,1,1,3
9522,s1746730763,1746730763,궁전헤어뱅크,1,1,1,3
9523,s20912380,20912380,오드리헵번,1,1,1,3
9524,s1452689674,1452689674,HAARE,1,1,1,3
9525,sk18449649,k18449649,토모토모,1,1,1,3
9526,s33158415,33158415,아이노헤어,1,1,1,3
9527,s11728755,11728755,나이스가이 수서역점,1,1,1,3
9528,s20454556,20454556,가연미용실,1,1,1,3
9529,s18916134,18916134,오즈헤어샵,1,1,1,3
9530,s32073742,32073742,별미용실,1,1,1,3
9531,s1134226882,1134226882,미미헤어,1,1,1,3
9532,s841810058,841810058,영미용실,1,1,1,3
9533,s36005200,36005200,가나미용실,1,1,1,3
9534,s527579612,527579612,챠밍미용실,1,1,1,3
9535,s37311287,37311287,김창숙헤어,1,1,1,3
9536,s13159536,13159536,다인헤어,1,1,1,3
9537,s36914622,36914622,바람부는날,1,1,1,3
9538,s537645514,537645514,베스트헤어,1,1,1,3
9539,s1724198779,1724198779,까끌레뽀끌레,1,1,1,3
9540,s1461723373,1461723373,미주헤어샵,1,1,1,3
9541,s18576003,18576003,헤어틈,1,1,1,3
9542,s1037427783,1037427783,개성연출,1,1,1,3
9543,s47158624,47158624,스칼렛헤어,1,1,1,3
9544,s18901039,18901039,안승희헤어뉴스,1,1,1,3
9545,s1155499988,1155499988,샴푸미용실,1,1,1,3
9546,s18921085,18921085,아띠헤어,1,1,1,3
9547,s38507473,38507473,헤어바이순정,1,1,1,3
9548,s37876762,37876762,쏠로아떼헤어,1,1,1,3
9549,s1821194912,1821194912,프리티헤어,1,1,1,3
9550,s1190393279,1190393279,오현숙미용실,1,1,1,3
9551,s18581561,18581561,루비황미용실,1,1,1,3
9552,s18904155,18904155,세리헤어클럽,1,1,1,3
9553,s886476244,886476244,이쁠리에헤어,1,1,1,3
9554,s1029366287,1029366287,머리할때 이쁘잖아,1,1,1,3
9555,s1494293993,1494293993,fine,1,1,1,3
9556,s1015231432,1015231432,포맨헤어,1,1,1,3
9557,s1124591203,1124591203,벨뷰티 BELLE BEAUTY,1,1,1,3
9558,s1981247495,1981247495,디세븐헤어살롱,1,1,1,3
9559,s1991148430,1991148430,토리헤어 수서역점,1,1,1,3
9560,s84730864,84730864,혼자헤어,1,1,1,3
9561,s1650325464,1650325464,디오브제 청담,1,1,1,3
9562,s31237805,31237805,프라쟈헤어,1,1,1,3
9563,s1680516928,1680516928,윤정헤어아트,1,1,1,3
9564,s21244486,21244486,제이브라운헤어,1,1,1,3
9565,s1465681345,1465681345,강남헤어쌀롱,1,1,1,3
9566,s1018478940,1018478940,헤어바이율,1,1,1,3
9567,s1102759555,1102759555,꼬꼬헤어샾,1,1,1,3
9568,s18597352,18597352,엥떼르메드,1,1,1,3
9569,s1221466225,1221466225,촤리,1,1,1,3
9570,s1300826146,1300826146,윤화헤어,1,1,1,3
9571,s20633323,20633323,김경헤어,1,1,1,3
9572,s569942506,569942506,헤어살롱보람,1,1,1,3
9573,s20621134,20621134,지젤헤어,1,1,1,3
9574,s36727629,36727629,헤어블링,1,1,1,3
9575,s1298259157,1298259157,끌림,1,1,1,3
9576,s454708080,454708080,영스헤어,1,1,1,3
9577,s1082377052,1082377052,오페라헤어,1,1,1,3
9578,s191658046,191658046,새아떼헤어,1,1,1,3
9579,s18903774,18903774,리자르헤어,1,1,1,3
9580,s958081800,958081800,미에뜰헤어,1,1,1,3
9581,s18898815,18898815,수진헤어뱅크,1,1,1,3
9582,s76226676,76226676,태후사랑 길동점,1,1,1,3
9583,s34052590,34052590,나인헤어,1,1,1,3
9584,s1579538855,1579538855,메르시헤어,1,1,1,3
9585,s19381953,19381953,지니헤어,1,1,1,3
9586,s1384163866,1384163866,사라헤어,1,1,1,3
9587,s1224745661,1224745661,맨즈샵,1,1,1,3
9588,s1648070720,1648070720,헤르메스헤어샵,1,1,1,3
9589,s18658582,18658582,칼라미용실,1,1,1,3
9590,s1808465981,1808465981,델루나,1,1,1,3
9591,s474571308,474571308,예지헤어,1,1,1,3
9592,s30886145,30886145,리조이스헤어샵,1,1,1,3
9593,s1027320342,1027320342,온뷰티살롱,1,1,1,3
9594,s18913200,18913200,원앤원헤어,1,1,1,3
9595,s18620660,18620660,리노미장,1,1,1,3
9596,s1194287539,1194287539,가시버시헤어샵,1,1,1,3
9597,s1250857566,1250857566,모드아헤어,1,1,1,3
9598,s20526606,20526606,에벤에셀헤어,1,1,1,3
9599,s1916962535,1916962535,곽은희헤어,1,1,1,3
9600,s38270822,38270822,니콜헤어,1,1,1,3
9601,s38501152,38501152,헤어파르페,1,1,1,3
9602,s18660090,18660090,미스터미용실,1,1,1,3
9603,s1920741155,1920741155,헬로우컷 길동점,1,1,1,3
9604,s34897694,34897694,서브웨이헤어샵,1,1,1,3
9605,s1115480729,1115480729,엠헤어,1,1,1,3
9606,s1035663262,1035663262,미앤유헤어샵,1,1,1,3
9607,s18901144,18901144,S쁘아미용실,1,1,1,3
9608,s1502202552,1502202552,루시헤어,1,1,1,3
9609,s143768480,143768480,헤어스토리,1,1,1,3
9610,s1557751160,1557751160,마샬미용실,1,1,1,3
9611,s1181723507,1181723507,아름다운 헤어,1,1,1,3
9612,s33068000,33068000,어린초목헤어샵,1,1,1,3
9613,s740452421,740452421,필헤어,1,1,1,3
9614,s1437036840,1437036840,아름다운헤어샵,1,1,1,3
9615,s20641229,20641229,까미헤어길동점,1,1,1,3
9616,s13156750,13156750,씨에프미용실,1,1,1,3
9617,s1968508940,1968508940,나이스헤어클럽,1,1,1,3
9618,s18898512,18898512,프랜들리헤어샵,1,1,1,3
9619,s18472063,18472063,에스엠프로헤어대치점,1,1,1,3
9620,s1167072234,1167072234,헤어20J 선릉점,1,1,1,3
9621,s20635272,20635272,GAYEON,1,1,1,3
9622,s20628064,20628064,다인헤어,1,1,1,3
9623,s20634349,20634349,유채화미용실,1,1,1,3
9624,s11628733,11628733,린다부티팡,1,1,1,3
9625,s1885096022,1885096022,세비야이발관,1,1,1,3
9626,s32448438,32448438,석희정미용실,1,1,1,3
9627,s1290631791,1290631791,나이스가이 강남삼성점,1,1,1,3
9628,s1623354365,1623354365,에이치헤어,1,1,1,3
9629,s1716921794,1716921794,헤어 원2,1,1,1,3
9630,s1867977490,1867977490,나이스가이 강남역점,1,1,1,3
9631,s1287942268,1287942268,승현헤어샵,1,1,1,3
9632,s1823727267,1823727267,루체헤어,1,1,1,3
9633,s1408474110,1408474110,블로우블러쉬,1,1,1,3
9634,s1240647799,1240647799,에이드 헤어,1,1,1,3
9635,s1765200520,1765200520,오샤레헤어,1,1,1,3
9636,s1531483168,1531483168,온니헤어,1,1,1,3
9637,s1878897318,1878897318,정쌀롱,1,1,1,3
9638,s20634560,20634560,블루클럽 매봉역점,1,1,1,3
9639,s1479366775,1479366775,작업실,1,1,1,3
9640,s1455310794,1455310794,마루니헤어,1,1,1,3
9641,s37889259,37889259,임지나헤어,1,1,1,3
9642,s987259482,987259482,효재미용실,1,1,1,3
9643,s34332980,34332980,김민지헤어샾,1,1,1,3
9644,s1939741934,1939741934,아무무붙임머리,1,1,1,3
9645,s20621798,20621798,지호헤어몰,1,1,1,3
9646,s1063882601,1063882601,블루클럽 자곡점,1,1,1,3
9647,s771987955,771987955,박찬순헤어,1,1,1,3
9648,s950117708,950117708,위살롱,1,1,1,3
9649,s581539655,581539655,준헤어,1,1,1,3
9650,s21884450,21884450,블루클럽 영동전화국점,1,1,1,3
9651,s529114355,529114355,모습 헤어살롱,1,1,1,3
9652,s49224468,49224468,임창희헤어,1,1,1,3
9653,s30923159,30923159,공리미용실,1,1,1,3
9654,s1541113125,1541113125,카미유헤어,1,1,1,3
9655,s1837670175,1837670175,정스헤어샵,1,1,1,3
9656,s68125570,68125570,은살롱,1,1,1,3
9657,s1776637261,1776637261,에이플러스헤어,1,1,1,3
9658,s1224586404,1224586404,원트헤어,1,1,1,3
9659,s1605907196,1605907196,아르테 바이 경민,1,1,1,3
9660,s1981208306,1981208306,스타일리스트정희,1,1,1,3
9661,s1835266129,1835266129,쁘띠헤어샵,1,1,1,3
9662,s1748238729,1748238729,머리못하는집,1,1,1,3
9663,s20640858,20640858,뉴맨헤어,1,1,1,3
9664,s1646235434,1646235434,장미미용실,1,1,1,3
9665,s1720586366,1720586366,H&J 헤어살롱,1,1,1,3
9666,s1023664809,1023664809,이훈헤어 선릉점,1,1,1,3
9667,s1109220382,1109220382,살롱조인,1,1,1,3
9668,s11693868,11693868,살롱드 제이,1,1,1,3
9669,s18413299,18413299,엘리스헤어,1,1,1,3
9670,s401410679,401410679,헤어샤샤,1,1,1,3
9671,s142455756,142455756,헤어익스텐션,1,1,1,3
9672,s35271809,35271809,탑제이헤어,1,1,1,3
9673,s11868993,11868993,미의세셰,1,1,1,3
9674,s34635450,34635450,드라마헤어,1,1,1,3
9675,s1993407023,1993407023,그날애,1,1,1,3
9676,s13150115,13150115,헤어프린스,1,1,1,3
9677,s20885716,20885716,성수미용실,1,1,1,3
9678,s36112274,36112274,리제이헤어,1,1,1,3
9679,s1154769089,1154769089,아띠,1,1,1,3
9680,s1527047205,1527047205,오늘도 헤어,1,1,1,3
9681,s1010046747,1010046747,dibujohairsalon,1,1,1,3
9682,s1808787156,1808787156,비브헤어,1,1,1,3
9683,s1131168068,1131168068,라보떼,1,1,1,3
9684,s1846973517,1846973517,와이하이,1,1,1,3
9685,s1910053778,1910053778,어느 멋진날에,1,1,1,3
9686,s1986960075,1986960075,디샵헤어,1,1,1,3
9687,s1673434970,1673434970,살롱드라비,1,1,1,3
9688,s1690924888,1690924888,더쎈헤어,1,1,1,3
9689,s13150105,13150105,케이헤어샵,1,1,1,3
9690,s1758029924,1758029924,헬로우컷 세곡점,1,1,1,3
9691,s1602760069,1602760069,루다헤어,1,1,1,3
9692,s1131773784,1131773784,청미용실,1,1,1,3
9693,s1699384405,1699384405,르메르디앙헤어,1,1,1,3
9694,s73222988,73222988,굿데이정윤,1,1,1,3
9695,s1839199193,1839199193,헤어리나,1,1,1,3
9696,s1281589598,1281589598,쥴리스살롱,1,1,1,3
9697,sk1862397019,k1862397019,라미헤어,1,1,1,3
9698,s1830097209,1830097209,컷트클럽,1,1,1,3
9699,s1713752667,1713752667,이음붙임머리,1,1,1,3
9700,s1390435983,1390435983,hairbyms,1,1,1,3
9701,s1436348857,1436348857,빠글뽀글,1,1,1,3
9702,s1288992015,1288992015,헤어바이봄,1,1,1,3
9703,s1112366628,1112366628,헤어메이크업에이,1,1,1,3
9704,s32340475,32340475,아티코뷰티헤어샵,1,1,1,3
9705,s13561426,13561426,유나헤어,1,1,1,3
9706,s1070300101,1070300101,아쥬르,1,1,1,3
9707,s30925178,30925178,휴헤어,1,1,1,3
9708,s18796440,18796440,K헤어,1,1,1,3
9709,s85560116,85560116,스타트헤어,1,1,1,3
9710,s21666964,21666964,브이원헤어,1,1,1,3
9711,s1178608651,1178608651,허즈헤어샵,1,1,1,3
9712,s20837259,20837259,헤어명가,1,1,1,3
9713,s20890684,20890684,헤어2000미용실,1,1,1,3
9714,s1665978361,1665978361,헤어0225,1,1,1,3
9715,s20848777,20848777,언니네살롱,1,1,1,3
9716,s1123644581,1123644581,한마음미용실,1,1,1,3
9717,s20921549,20921549,KIZUNA,1,1,1,3
9718,s1299984732,1299984732,밀라노미용실,1,1,1,3
9719,s1937182474,1937182474,살롱드미모,1,1,1,3
9720,s1976592681,1976592681,소연헤어,1,1,1,3
9721,s1667918726,1667918726,세븐미용실,1,1,1,3
9722,s1102212519,1102212519,햇님미용실,1,1,1,3
9723,s1857266014,1857266014,5세5염색,1,1,1,3
9724,s20898795,20898795,레아헤어,1,1,1,3
9725,s1701075476,1701075476,에스더미용실,1,1,1,3
9726,s1048275674,1048275674,헤어핀,1,1,1,3
9727,s1173945379,1173945379,이끌림헤어,1,1,1,3
9728,s18606912,18606912,훈헤어,1,1,1,3
9729,s1674159217,1674159217,글로우바이엠헤어,1,1,1,3
9730,s1507573437,1507573437,Mc헤어,1,1,1,3
9731,s1903266654,1903266654,아쿠아블루,1,1,1,3
9732,s1929289571,1929289571,살롱드헤어,1,1,1,3
9733,s1611765944,1611765944,진&정헤어,1,1,1,3
9734,s1284430777,1284430777,이훈ALL30000,1,1,1,3
9735,s20847587,20847587,머리하는날,1,1,1,3
9736,s1933306090,1933306090,미사헤어,1,1,1,3
9737,s1693063312,1693063312,더예쁨,1,1,1,3
9738,s1236323313,1236323313,준스헤어,1,1,1,3
9739,s1307413057,1307413057,아뜰리에채린,1,1,1,3
9740,s1979208112,1979208112,피카소헤어,1,1,1,3
9741,s37609444,37609444,에이치앤엘헤어,1,1,1,3
9742,s1753734210,1753734210,진주미용실,1,1,1,3
9743,s31392980,31392980,문헤어월드,1,1,1,3
9744,s1815085232,1815085232,헤어살롱허가미쟝,1,1,1,3
9745,s37684139,37684139,뷰티헤어 살롱하이레,1,1,1,3
9746,s1192871842,1192871842,현헤어,1,1,1,3
9747,s17949498,17949498,머리자르기,1,1,1,3
9748,s37992706,37992706,옻 안타는 천연염색 번동점,1,1,1,3
9749,s1751552818,1751552818,신헤어,1,1,1,3
9750,s18611555,18611555,헤어가온,1,1,1,3
9751,s1206713947,1206713947,산뜻한헤어,1,1,1,3
9752,s1481344465,1481344465,아이시떼루헤어클럽,1,1,1,3
9753,s1552247579,1552247579,수미용실,1,1,1,3
9754,s87337741,87337741,진헤어,1,1,1,3
9755,s38502094,38502094,퀸즈헤나헤어,1,1,1,3
9756,s1443715410,1443715410,최은정헤어,1,1,1,3
9757,s81559415,81559415,감동을더하다,1,1,1,3
9758,s1197143967,1197143967,헤어도로시,1,1,1,3
9759,s17947668,17947668,헤어스케치,1,1,1,3
9760,s17932840,17932840,머리하기좋은날,1,1,1,3
9761,s1366979304,1366979304,에스더블유헤어샵,1,1,1,3
9762,s97365804,97365804,박쿤혜어,1,1,1,3
9763,s1829133682,1829133682,리즈헤어,1,1,1,3
9764,s34557029,34557029,허생헤어,1,1,1,3
9765,s1009682173,1009682173,큐사랑 강북점,1,1,1,3
9766,s20871319,20871319,진미용타운,1,1,1,3
9767,s1544234838,1544234838,한임석153미모아트,1,1,1,3
9768,s1903006768,1903006768,프리헤어아트,1,1,1,3
9769,s20917265,20917265,그린헤어샵,1,1,1,3
9770,s1698985971,1698985971,성원미용실,1,1,1,3
9771,s1037182697,1037182697,국제미용실,1,1,1,3
9772,s20909559,20909559,NEW밀레니엄미용실,1,1,1,3
9773,s1404072808,1404072808,댕기머리헤어,1,1,1,3
9774,s20894374,20894374,승희머리방,1,1,1,3
9775,s20863563,20863563,수예헤어샵,1,1,1,3
9776,s20932361,20932361,슬기미용실,1,1,1,3
9777,s1861909716,1861909716,만나미용실,1,1,1,3
9778,s18372674,18372674,김선희헤어패션,1,1,1,3
9779,s20909746,20909746,장미용실,1,1,1,3
9780,s35734756,35734756,쎄씨헤어화곡역점,1,1,1,3
9781,s20906293,20906293,고운미용실,1,1,1,3
9782,s1404117092,1404117092,펌&컷,1,1,1,3
9783,s1021716449,1021716449,오땡큐염색전문,1,1,1,3
9784,s1437960882,1437960882,아토헤어,1,1,1,3
9785,s1952332523,1952332523,토리헤어 미아역점,1,1,1,3
9786,s1728495859,1728495859,더스타일헤어,1,1,1,3
9787,s1025734580,1025734580,초이스헤어,1,1,1,3
9788,s1005741592,1005741592,위너제이헤어,1,1,1,3
9789,s1039157951,1039157951,헤어위드레이,1,1,1,3
9790,s1075862923,1075862923,오케이헤어,1,1,1,3
9791,s1071631715,1071631715,헤어공방,1,1,1,3
9792,s1484359273,1484359273,유나헤어,1,1,1,3
9793,s1938104212,1938104212,현정헤어샵,1,1,1,3
9794,s18606733,18606733,머리깍쟁이미용실,1,1,1,3
9795,s1262963696,1262963696,크리스탈헤어,1,1,1,3
9796,s1548353700,1548353700,아이원헤어,1,1,1,3
9797,s1705058571,1705058571,임원장뷰티카페,1,1,1,3
9798,s1897754114,1897754114,카롱헤어,1,1,1,3
9799,s1234438944,1234438944,마르떼헤어,1,1,1,3
9800,s1837236063,1837236063,머리뽁는미스고,1,1,1,3
9801,s1724587445,1724587445,더엠,1,1,1,3
9802,s1078263593,1078263593,JJ헤어,1,1,1,3
9803,s18617093,18617093,줄리엣헤어,1,1,1,3
9804,s1287185466,1287185466,글로리아헤어,1,1,1,3
9805,s1278111641,1278111641,슈슈헤어,1,1,1,3
9806,s97972696,97972696,애교머리헤어,1,1,1,3
9807,s1009310358,1009310358,제이헤어,1,1,1,3
9808,s1077400717,1077400717,민정헤어샵,1,1,1,3
9809,s20891146,20891146,하늘세상,1,1,1,3
9810,s34352999,34352999,헤어샵Adelyne수유본점,1,1,1,3
9811,s34352126,34352126,파루벨르태양헤어클럽강북점,1,1,1,3
9812,s31395701,31395701,두비두헤어,1,1,1,3
9813,s37928193,37928193,머리꼭대기,1,1,1,3
9814,s19455266,19455266,유스헤어,1,1,1,3
9815,s18602697,18602697,펄쉬헤어,1,1,1,3
9816,s35928215,35928215,K hair,1,1,1,3
9817,s1644745292,1644745292,머리나르샤,1,1,1,3
9818,s37634328,37634328,시크헤어,1,1,1,3
9819,s1803161312,1803161312,지앤미헤어,1,1,1,3
9820,s1120796671,1120796671,더헤어,1,1,1,3
9821,s1336807882,1336807882,헤어더유니즌,1,1,1,3
9822,s1548240815,1548240815,도도헤어,1,1,1,3
9823,s34353236,34353236,헤어파티,1,1,1,3
9824,s1365745439,1365745439,헤어센스,1,1,1,3
9825,s20860370,20860370,올리브헤어샵,1,1,1,3
9826,s1370337048,1370337048,김근현헤어샵,1,1,1,3
9827,s1700818390,1700818390,이화미용실,1,1,1,3
9828,s1127221573,1127221573,젤자레헤어,1,1,1,3
9829,s1685487827,1685487827,샴푸와린스,1,1,1,3
9830,s1071544280,1071544280,헤어 이끌림,1,1,1,3
9831,s1217795587,1217795587,보보헤어,1,1,1,3
9832,s1533423923,1533423923,엘르미용실,1,1,1,3
9833,sk21201572,k21201572,정란미용실,1,1,1,3
9834,s20940482,20940482,정란헤어모드,1,1,1,3
9835,s693293616,693293616,더헤어,1,1,1,3
9836,s1852439603,1852439603,헤어뉴스,1,1,1,3
9837,s1542991408,1542991408,제이스타일,1,1,1,3
9838,s1951746258,1951746258,헤어준,1,1,1,3
9839,s1684677898,1684677898,제이블랑,1,1,1,3
9840,s1647500165,1647500165,루헤어엔네일,1,1,1,3
9841,s19582316,19582316,헤어카페GQ,1,1,1,3
9842,s50112829,50112829,아인헤어,1,1,1,3
9843,s1269531028,1269531028,티나헤어,1,1,1,3
9844,s1064675070,1064675070,더w헤어,1,1,1,3
9845,s35069381,35069381,베네치아미용실,1,1,1,3
9846,s1091381400,1091381400,차르망헤어,1,1,1,3
9847,s34573932,34573932,지영헤어,1,1,1,3
9848,s1624243542,1624243542,시크릿헤어,1,1,1,3
9849,s1202510139,1202510139,이선미헤어,1,1,1,3
9850,s37703672,37703672,원살롱,1,1,1,3
9851,s31392280,31392280,설레임2개,1,1,1,3
9852,s31396013,31396013,까까머리,1,1,1,3
9853,s1568914642,1568914642,s헤어,1,1,1,3
9854,s1093986833,1093986833,헤어스토리,1,1,1,3
9855,s1622894547,1622894547,유월헤어,1,1,1,3
9856,s35188013,35188013,멋진맨,1,1,1,3
9857,s1432021356,1432021356,지니헤어,1,1,1,3
9858,s38703885,38703885,제이헤어네일,1,1,1,3
9859,s1296680212,1296680212,유니크헤어,1,1,1,3
9860,s1832282864,1832282864,헤어애,1,1,1,3
9861,s36630944,36630944,미스리미장원,1,1,1,3
9862,s1112556347,1112556347,예쁜염색미용실,1,1,1,3
9863,s36435369,36435369,BOB style,1,1,1,3
9864,s1456630337,1456630337,주주헤어,1,1,1,3
9865,s37293835,37293835,자몽헤어,1,1,1,3
9866,s18601640,18601640,목화미용실,1,1,1,3
9867,s1786799478,1786799478,헤어잘,1,1,1,3
9868,s480087176,480087176,이안헤어,1,1,1,3
9869,s1501951570,1501951570,THE봄 Hair,1,1,1,3
9870,s37081326,37081326,180도헤어케어 삼양사거리점,1,1,1,3
9871,s37326193,37326193,헤어데이즈,1,1,1,3
9872,s1575661612,1575661612,감성,1,1,1,3
9873,s37629958,37629958,blond,1,1,1,3
9874,s1594275235,1594275235,머리나라,1,1,1,3
9875,s1006691072,1006691072,H헤어,1,1,1,3
9876,s33073090,33073090,리헤어,1,1,1,3
9877,s37185948,37185948,머리치장,1,1,1,3
9878,s34354590,34354590,다인머리하는집,1,1,1,3
9879,s1224583968,1224583968,이상희헤어샵,1,1,1,3
9880,s20912421,20912421,여우머리,1,1,1,3
9881,sk17943810,k17943810,청담미용실,1,1,1,3
9882,s1049395122,1049395122,오뜨헤어,1,1,1,3
9883,s1973676994,1973676994,라임헤어,1,1,1,3
9884,s897463667,897463667,더샵오드리,1,1,1,3
9885,s1394425863,1394425863,도담헤어,1,1,1,3
9886,s1106633096,1106633096,준투미용타운,1,1,1,3
9887,s18628826,18628826,엄지헤어,1,1,1,3
9888,s17944346,17944346,덕수이발관,1,1,1,3
9889,s20885619,20885619,예쁜머리헤어샵,1,1,1,3
9890,s1009587751,1009587751,은주헤어,1,1,1,3
9891,s1542255603,1542255603,헤어조이,1,1,1,3
9892,s1357037881,1357037881,1인아름다움,1,1,1,3
9893,s1875510371,1875510371,승은헤어,1,1,1,3
9894,s1741045032,1741045032,고센헤어컷,1,1,1,3
9895,s33021368,33021368,LA DOLCE VITA,1,1,1,3
9896,s20863644,20863644,아름다울미,1,1,1,3
9897,s20879293,20879293,라온헤어샵,1,1,1,3
9898,s1682509210,1682509210,베다니미용실,1,1,1,3
9899,s38753117,38753117,은하헤어뷰,1,1,1,3
9900,s1819357996,1819357996,느낌헤어샵,1,1,1,3
9901,s20936321,20936321,헤어박스,1,1,1,3
9902,s20886948,20886948,나나미용실,1,1,1,3
9903,s18942357,18942357,이레나헤어루주,1,1,1,3
9904,s20867726,20867726,예뜨아띠,1,1,1,3
9905,s1529589067,1529589067,명동헤어샵,1,1,1,3
9906,s1584902721,1584902721,고운미용실,1,1,1,3
9907,s20867537,20867537,은미미용타운,1,1,1,3
9908,s20898298,20898298,서희진미용실,1,1,1,3
9909,s18934285,18934285,도영헤어,1,1,1,3
9910,s18939764,18939764,썬헤어라인,1,1,1,3
9911,s20890640,20890640,유진헤어라인,1,1,1,3
9912,s20848489,20848489,이지희헤어라인,1,1,1,3
9913,s20905786,20905786,현미용타운,1,1,1,3
9914,s1856438820,1856438820,민정헤어클리닉,1,1,1,3
9915,s1456047513,1456047513,규방프로헤어,1,1,1,3
9916,s19846864,19846864,헤어팰리스 발산점,1,1,1,3
9917,s1675314982,1675314982,채연헤어,1,1,1,3
9918,s13152329,13152329,임스헤어살롱,1,1,1,3
9919,s1020179297,1020179297,샤인헤어,1,1,1,3
9920,s1580498866,1580498866,청담헤어네일,1,1,1,3
9921,s1246637648,1246637648,쥴리앙미용실,1,1,1,3
9922,s1055784676,1055784676,심쿵헤어,1,1,1,3
9923,s36788926,36788926,간지루헤어,1,1,1,3
9924,s1187539442,1187539442,거기 기분좋은곳,1,1,1,3
9925,s32874769,32874769,머리이야기미용실,1,1,1,3
9926,s31729731,31729731,김소율헤어,1,1,1,3
9927,s1441700194,1441700194,정순헤어,1,1,1,3
9928,s1034191873,1034191873,까까머리,1,1,1,3
9929,s18943251,18943251,지니헤어갤러리,1,1,1,3
9930,s64610428,64610428,끌어모아미용실,1,1,1,3
9931,s1617728205,1617728205,준헤어,1,1,1,3
9932,s20920842,20920842,여우머리HAIR,1,1,1,3
9933,s1480143028,1480143028,수림헤어,1,1,1,3
9934,s18400628,18400628,헤어클레시스,1,1,1,3
9935,s1635596643,1635596643,미즈헤어,1,1,1,3
9936,s36603071,36603071,ST뷰티센터,1,1,1,3
9937,s20886741,20886741,리헤어샵,1,1,1,3
9938,s1754611532,1754611532,타스헤어 화곡점,1,1,1,3
9939,s37696115,37696115,헤어플랜비,1,1,1,3
9940,s1764468152,1764468152,컷앤펌,1,1,1,3
9941,s20742774,20742774,예원헤어,1,1,1,3
9942,s33636401,33636401,H STYLE 헤어살롱 우장산점,1,1,1,3
9943,s18948504,18948504,예쁘게헤어,1,1,1,3
9944,s12065328,12065328,노스헤어화곡역점,1,1,1,3
9945,s36264766,36264766,멋들헤어아트,1,1,1,3
9946,s20832884,20832884,훈헤어아트,1,1,1,3
9947,s1992095658,1992095658,햇빛헤어센스,1,1,1,3
9948,s1577341113,1577341113,이옥희미용실,1,1,1,3
9949,s20909827,20909827,석경남미용실,1,1,1,3
9950,s1679504490,1679504490,새로본미용실,1,1,1,3
9951,s20855821,20855821,초원미용실,1,1,1,3
9952,s20901889,20901889,헤어월드미용실,1,1,1,3
9953,s11861131,11861131,월드피아 미용가구,1,1,1,3
9954,s20851524,20851524,소라미용실,1,1,1,3
9955,s20920972,20920972,윤헤어라인,1,1,1,3
9956,s20920898,20920898,선영헤어샵,1,1,1,3
9957,s18388250,18388250,윤미용실,1,1,1,3
9958,s1909928811,1909928811,은혜미용실,1,1,1,3
9959,s1442820095,1442820095,무이헤어,1,1,1,3
9960,s37383571,37383571,란스헤어,1,1,1,3
9961,s20913407,20913407,블루클럽 가양1동점,1,1,1,3
9962,s20886797,20886797,러블리헤어,1,1,1,3
9963,s1386212417,1386212417,라임헤어살롱,1,1,1,3
9964,s1674592943,1674592943,한강미용실,1,1,1,3
9965,s20840480,20840480,머리하는날,1,1,1,3
9966,s20820852,20820852,헤어짱,1,1,1,3
9967,s31400644,31400644,JH헤어,1,1,1,3
9968,s18327065,18327065,칼라칼라헤어샵,1,1,1,3
9969,s20844399,20844399,명덕미용실,1,1,1,3
9970,s20820982,20820982,까꼬뽀꼬미용실,1,1,1,3
9971,s20828872,20828872,이지헤어,1,1,1,3
9972,s18360703,18360703,로즈핑크,1,1,1,3
9973,s20329677,20329677,오즈미용실,1,1,1,3
9974,s20894271,20894271,씨마헤어샵,1,1,1,3
9975,s1102960025,1102960025,제이엔영뷰티헤어,1,1,1,3
9976,s20828749,20828749,헤어랑,1,1,1,3
9977,s18408600,18408600,선한미용실,1,1,1,3
9978,s1159635045,1159635045,미스터리헤어하우스,1,1,1,3
9979,s20909744,20909744,구본애헤어클럽,1,1,1,3
9980,s1952989916,1952989916,헤어주,1,1,1,3
9981,s1707442795,1707442795,가지미용실,1,1,1,3
9982,s916222158,916222158,에이치클래스헤어우장산역점,1,1,1,3
9983,s1129783372,1129783372,미녀와미남이,1,1,1,3
9984,s1158377517,1158377517,마샬헤어크리닉,1,1,1,3
9985,s20875214,20875214,강수연헤어아트,1,1,1,3
9986,s20928591,20928591,인지헤어샵,1,1,1,3
9987,s1061675003,1061675003,상아미용실,1,1,1,3
9988,s19957534,19957534,헤어끌레오,1,1,1,3
9989,s20366345,20366345,머리이야기,1,1,1,3
9990,s18372676,18372676,미세스박파마타운,1,1,1,3
9991,s20894497,20894497,김은숙헤어뉴스,1,1,1,3
9992,s1687644223,1687644223,KBS헤어,1,1,1,3
9993,s18951317,18951317,유안나미용실,1,1,1,3
9994,s18954105,18954105,신숙미용실,1,1,1,3
9995,s20820945,20820945,개나리미용실,1,1,1,3
9996,s1475428557,1475428557,귀빈 남성컷트전문점,1,1,1,3
9997,s20913287,20913287,핑크미용실,1,1,1,3
9998,s20828924,20828924,TAK헤어,1,1,1,3
9999,s1947211090,1947211090,수민미용실,1,1,1,3
10000,s1106960243,1106960243,박인경헤어컬렉션,1,1,1,3
10001,s1220895849,1220895849,제이빔,1,1,1,3
10002,s1702743796,1702743796,지니헤어,1,1,1,3
10003,s18413077,18413077,세븐헤어라인,1,1,1,3
10004,s18951144,18951144,헤어펌&컬러,1,1,1,3
10005,s1739470360,1739470360,플러스헤어샵,1,1,1,3
10006,s1421452280,1421452280,제니헤어샵,1,1,1,3
10007,s20928547,20928547,권영란헤어샵,1,1,1,3
10008,s18411569,18411569,이삭헤어샵,1,1,1,3
10009,s20917317,20917317,기분업,1,1,1,3
10010,s1489012291,1489012291,헤어갤러리,1,1,1,3
10011,s20863674,20863674,헤어빈,1,1,1,3
10012,s1243038509,1243038509,주주헤어,1,1,1,3
10013,s18953042,18953042,김희선헤어라인,1,1,1,3
10014,s18951420,18951420,준헤어,1,1,1,3
10015,s20879064,20879064,방화미용실,1,1,1,3
10016,s1110585974,1110585974,젠틀클럽 방화점,1,1,1,3
10017,s1042453686,1042453686,오땡큐 방화1동점,1,1,1,3
10018,s37766542,37766542,스완미용실,1,1,1,3
10019,s663054986,663054986,유민헤어샵,1,1,1,3
10020,s30868349,30868349,더컷남성헤어샵,1,1,1,3
10021,s36993788,36993788,현미용실,1,1,1,3
10022,s1098848299,1098848299,열정살롱,1,1,1,3
10023,s858960522,858960522,연헤어,1,1,1,3
10024,s1775706975,1775706975,우두머리미용실,1,1,1,3
10025,s18412009,18412009,이선이미용실,1,1,1,3
10026,s20890568,20890568,주주헤어클럽,1,1,1,3
10027,s1838151749,1838151749,크리스티나헤어샵,1,1,1,3
10028,s36849895,36849895,임수미헤어,1,1,1,3
10029,s20836573,20836573,다미헤어라인,1,1,1,3
10030,s36886631,36886631,본헤어,1,1,1,3
10031,s18952946,18952946,정은정헤어,1,1,1,3
10032,s20852219,20852219,까모헤어,1,1,1,3
10033,s1543999071,1543999071,신데렐라헤어,1,1,1,3
10034,s1431530081,1431530081,진헤어,1,1,1,3
10035,s20917318,20917318,지연헤어라인,1,1,1,3
10036,s153935299,153935299,헤어아벨,1,1,1,3
10037,s18935384,18935384,윤헤어,1,1,1,3
10038,s20859979,20859979,숙미용실,1,1,1,3
10039,s20882980,20882980,이즈헤어,1,1,1,3
10040,s1928195798,1928195798,련헤어센스,1,1,1,3
10041,s1352501653,1352501653,이발클럽로미오,1,1,1,3
10042,s20928531,20928531,나드리미용실,1,1,1,3
10043,s20863829,20863829,이미경헤어크리닉,1,1,1,3
10044,s19952394,19952394,박성연 남성헤어샵,1,1,1,3
10045,s20886733,20886733,리나미용실,1,1,1,3
10046,s20871427,20871427,벨라헤어샵,1,1,1,3
10047,s1005104395,1005104395,승민헤어,1,1,1,3
10048,s18381213,18381213,김미화미용실,1,1,1,3
10049,s771568398,771568398,더헤어157,1,1,1,3
10050,s1715018726,1715018726,ZS헤어살롱,1,1,1,3
10051,s1016905852,1016905852,욜로헤어,1,1,1,3
10052,s91419911,91419911,새로나미용실,1,1,1,3
10053,s1603632929,1603632929,노블헤어,1,1,1,3
10054,s18400298,18400298,홍파헤어,1,1,1,3
10055,s19535867,19535867,뭄싸롱헤어,1,1,1,3
10056,s1663769943,1663769943,헤어지지마,1,1,1,3
10057,s20863618,20863618,머리짱헤어,1,1,1,3
10058,s18944237,18944237,류혜진미용실,1,1,1,3
10059,s1834952588,1834952588,유미용실,1,1,1,3
10060,s1939251706,1939251706,바이민헤어,1,1,1,3
10061,s20848301,20848301,댕기따는날,1,1,1,3
10062,s20883034,20883034,희미용실,1,1,1,3
10063,s20924791,20924791,그린미용실,1,1,1,3
10064,s1005547483,1005547483,권헤어샵,1,1,1,3
10065,s34658249,34658249,나드리미용실 목동본점,1,1,1,3
10066,s18933945,18933945,예리미용실,1,1,1,3
10067,s18392778,18392778,리헤어클럽,1,1,1,3
10068,s333269215,333269215,구스헤어,1,1,1,3
10069,s1935984405,1935984405,라온헤어,1,1,1,3
10070,s37755023,37755023,라미&바니 헤어,1,1,1,3
10071,s389462546,389462546,아르채 헤어,1,1,1,3
10072,s579403751,579403751,수민헤어,1,1,1,3
10073,s1841007247,1841007247,헤어필,1,1,1,3
10074,s18929657,18929657,아름헤어샵,1,1,1,3
10075,s35545802,35545802,헤어바이 진진,1,1,1,3
10076,s18930155,18930155,임옥순헤어,1,1,1,3
10077,s1038043711,1038043711,플러스헤어샵,1,1,1,3
10078,s20898208,20898208,박두이헤어라인,1,1,1,3
10079,s20844580,20844580,박소영미용실,1,1,1,3
10080,s1072484467,1072484467,라임헤어,1,1,1,3
10081,s20821424,20821424,수경뷰티헤어,1,1,1,3
10082,s20856526,20856526,헤어나비,1,1,1,3
10083,s38753107,38753107,나폴레옹미용실,1,1,1,3
10084,s20925141,20925141,가위소리헤어샵,1,1,1,3
10085,s17940915,17940915,미센스헤어라인,1,1,1,3
10086,s20833310,20833310,산정헤어힐,1,1,1,3
10087,s34353011,34353011,원헤어샵,1,1,1,3
10088,s1858563535,1858563535,챠밍헤어샵,1,1,1,3
10089,s1847875070,1847875070,영미용실,1,1,1,3
10090,s20902488,20902488,최향미용실,1,1,1,3
10091,s20825298,20825298,W헤어,1,1,1,3
10092,s1287089329,1287089329,헤어뱅크,1,1,1,3
10093,s20841033,20841033,조이헤어라인,1,1,1,3
10094,s31950090,31950090,ss hair샵,1,1,1,3
10095,s1347486076,1347486076,헤어스토리봄,1,1,1,3
10096,s1533101341,1533101341,별헤어살롱미용실,1,1,1,3
10097,s11830842,11830842,쁘띠에뜨왈 미용실,1,1,1,3
10098,s36028322,36028322,이동우뷰티살롱,1,1,1,3
10099,s33078066,33078066,샴푸헤어,1,1,1,3
10100,s37417655,37417655,아름미용실,1,1,1,3
10101,s1852842002,1852842002,샹떼헤어수유점,1,1,1,3
10102,s1692253655,1692253655,마르떼헤어,1,1,1,3
10103,s1715868651,1715868651,서연미용실,1,1,1,3
10104,s38753108,38753108,정문영미용실,1,1,1,3
10105,s1078524699,1078524699,구가헤어샵,1,1,1,3
10106,s18616361,18616361,가나안머리방,1,1,1,3
10107,s18605329,18605329,헤어마을,1,1,1,3
10108,s1136084209,1136084209,양정은헤어샵,1,1,1,3
10109,s1177763357,1177763357,보보스헤어,1,1,1,3
10110,s18604140,18604140,가위손미용실,1,1,1,3
10111,s18599267,18599267,연지미용실,1,1,1,3
10112,s1999215965,1999215965,미남성헤어디자인,1,1,1,3
10113,s1806868807,1806868807,후투헤어,1,1,1,3
10114,s1459442477,1459442477,J미용실,1,1,1,3
10115,s18601634,18601634,신헤어매니저,1,1,1,3
10116,s1639153731,1639153731,이영애미용실,1,1,1,3
10117,s20921511,20921511,모던헤어숍,1,1,1,3
10118,s1001418043,1001418043,세븐미용실,1,1,1,3
10119,s1153486944,1153486944,구일뷰티플러스,1,1,1,3
10120,s11661101,11661101,정 미용실,1,1,1,3
10121,s1674023008,1674023008,디지털미용실,1,1,1,3
10122,s1141309622,1141309622,문승희미용실,1,1,1,3
10123,s1792085082,1792085082,세연미용실,1,1,1,3
10124,s17907665,17907665,럭키미용실,1,1,1,3
10125,s18602986,18602986,수산나미용타운,1,1,1,3
10126,s36230051,36230051,카라헤어,1,1,1,3
10127,s20821346,20821346,추혜숙헤어샵,1,1,1,3
10128,s1795731716,1795731716,지니헤어샵,1,1,1,3
10129,s20875820,20875820,김주영단골미용실,1,1,1,3
10130,s1225325307,1225325307,쎄븐헤어,1,1,1,3
10131,s1245383733,1245383733,미헤어라인,1,1,1,3
10132,s32165122,32165122,자르세미장,1,1,1,3
10133,s38753109,38753109,조희미용실,1,1,1,3
10134,s1737783498,1737783498,지현헤어필,1,1,1,3
10135,s34355118,34355118,미즈오,1,1,1,3
10136,s17938298,17938298,은혜머리방,1,1,1,3
10137,s20932901,20932901,정헤어라인,1,1,1,3
10138,s34353165,34353165,라피아헤어,1,1,1,3
10139,s1190475850,1190475850,이선경미용실,1,1,1,3
10140,s18606205,18606205,현미헤어클럽,1,1,1,3
10141,s36005204,36005204,주헤어필,1,1,1,3
10142,s20844984,20844984,매직헤어,1,1,1,3
10143,s1600338674,1600338674,까까머리미용실,1,1,1,3
10144,s1004678010,1004678010,헤어플랜,1,1,1,3
10145,s628097284,628097284,MJ헤어,1,1,1,3
10146,s20906362,20906362,보보헤어,1,1,1,3
10147,s1759611798,1759611798,세실헤어샵,1,1,1,3
10148,s1487006158,1487006158,컷트클럽,1,1,1,3
10149,s18598766,18598766,케이원헤어,1,1,1,3
10150,s17949501,17949501,선희미용실,1,1,1,3
10151,s737510327,737510327,스타헤어,1,1,1,3
10152,s1563155755,1563155755,알리샤코코헤어,1,1,1,3
10153,s1167600059,1167600059,극동머리방,1,1,1,3
10154,s1750214196,1750214196,샤론미용실,1,1,1,3
10155,s1892579696,1892579696,윈디 남성헤어,1,1,1,3
10156,s901610444,901610444,성은헤어갤러리,1,1,1,3
10157,s242620079,242620079,헤어끌림,1,1,1,3
10158,s1200613174,1200613174,아름미용타운,1,1,1,3
10159,s1073087534,1073087534,김헤어컬랙션,1,1,1,3
10160,s967464825,967464825,미인헤어,1,1,1,3
10161,s18609874,18609874,체널헤어코코,1,1,1,3
10162,s20925446,20925446,헤어미스토리,1,1,1,3
10163,s20821383,20821383,조을미용실,1,1,1,3
10164,s1299715927,1299715927,샛별헤어아트,1,1,1,3
10165,s58092906,58092906,헤어story,1,1,1,3
10166,s866485962,866485962,장미원머리방,1,1,1,3
10167,s18614311,18614311,허미숙헤어뱅크,1,1,1,3
10168,s32403369,32403369,엣지헤어,1,1,1,3
10169,s1802200471,1802200471,쎄븐헤어,1,1,1,3
10170,s1024932617,1024932617,실비아미용실,1,1,1,3
10171,s1213276043,1213276043,나드리헤어샵,1,1,1,3
10172,s34353643,34353643,평화머리방,1,1,1,3
10173,s1254040764,1254040764,샵앤샵헤어,1,1,1,3
10174,s1143029747,1143029747,미노헤어미용실,1,1,1,3
10175,s1390757848,1390757848,낙원미용실,1,1,1,3
10176,s35143077,35143077,이선영머리방,1,1,1,3
10177,s20902541,20902541,소연헤어,1,1,1,3
10178,s18613603,18613603,이숙희헤어아트,1,1,1,3
10179,s470826300,470826300,SS헤어,1,1,1,3
10180,s37390894,37390894,미장원,1,1,1,3
10181,s32699621,32699621,하랑 헤어,1,1,1,3
10182,s1270222111,1270222111,오크라헤어,1,1,1,3
10183,s17907658,17907658,유정헤어샵,1,1,1,3
10184,s1584844863,1584844863,살롱드윤,1,1,1,3
10185,s17945790,17945790,정인선헤어필,1,1,1,3
10186,s1375009277,1375009277,가위손프로헤어,1,1,1,3
10187,s36536799,36536799,에이치앤엔,1,1,1,3
10188,s37603308,37603308,GK헤어,1,1,1,3
10189,s1322552200,1322552200,더한올헤어,1,1,1,3
10190,s1616322901,1616322901,머리사랑,1,1,1,3
10191,s1785259951,1785259951,고감헤어,1,1,1,3
10192,s1123605356,1123605356,수헤어,1,1,1,3
10193,s12829375,12829375,박선영헤어,1,1,1,3
10194,s18599838,18599838,개미미용실,1,1,1,3
10195,s18599562,18599562,보람미용실,1,1,1,3
10196,s20860451,20860451,미용실카리스마,1,1,1,3
10197,s1998314367,1998314367,헤어스토리 수유1호점,1,1,1,3
10198,s1315750128,1315750128,수경머리방,1,1,1,3
10199,s1210117465,1210117465,우이미용실,1,1,1,3
10200,s17942744,17942744,현미용실,1,1,1,3
10201,s1192081884,1192081884,아카데미헤어아트,1,1,1,3
10202,s11561677,11561677,선달미용실,1,1,1,3
10203,s18601409,18601409,허림미용실,1,1,1,3
10204,s1221608642,1221608642,헤어젠,1,1,1,3
10205,s1757090766,1757090766,유진헤어샵,1,1,1,3
10206,s1150008504,1150008504,박미용실,1,1,1,3
10207,s18612936,18612936,로즈미용실,1,1,1,3
10208,s17940923,17940923,개미미용실,1,1,1,3
10209,s20856281,20856281,고은미용타운,1,1,1,3
10210,s1834036145,1834036145,꽃초롱미용실,1,1,1,3
10211,s1898830650,1898830650,주연미용실,1,1,1,3
10212,s1914025190,1914025190,궁전헤어샵,1,1,1,3
10213,s1795123777,1795123777,규수당미용실,1,1,1,3
10214,s18616097,18616097,소진덕헤어라인,1,1,1,3
10215,s17940889,17940889,윤정머리방,1,1,1,3
10216,s34354447,34354447,준헤어샵,1,1,1,3
10217,s18603012,18603012,명신미용실,1,1,1,3
10218,s1672556174,1672556174,슈헤어,1,1,1,3
10219,s1908709318,1908709318,보라헤어,1,1,1,3
10220,s18604424,18604424,리움헤어,1,1,1,3
10221,s20879954,20879954,장미헤어샵,1,1,1,3
10222,s1802403572,1802403572,예머리방,1,1,1,3
10223,s1426299779,1426299779,귀빈미용실,1,1,1,3
10224,s1597454775,1597454775,바비정헤어,1,1,1,3
10225,s20925445,20925445,헤어모짜르트,1,1,1,3
10226,s38753111,38753111,마리아미용실,1,1,1,3
10227,s20902668,20902668,이재욱헤어라인,1,1,1,3
10228,s1104483424,1104483424,샬롬헤어,1,1,1,3
10229,s1526584137,1526584137,유림헤어샵,1,1,1,3
10230,s20898904,20898904,연다라미용실,1,1,1,3
10231,s18608236,18608236,댕기머리방,1,1,1,3
10232,s20891034,20891034,별미용실,1,1,1,3
10233,s1994735964,1994735964,더마리헤어,1,1,1,3
10234,s1359340680,1359340680,코지헤어,1,1,1,3
10235,s1012104306,1012104306,윤스헤어,1,1,1,3
10236,s1808324830,1808324830,제이제이헤어,1,1,1,3
10237,s19444485,19444485,윤헤어,1,1,1,3
10238,s1048230474,1048230474,HairDiva,1,1,1,3
10239,s1361448846,1361448846,컷팅클럽삼양시장점,1,1,1,3
10240,s1730015015,1730015015,라온헤어,1,1,1,3
10241,s18605264,18605264,푸른미용실,1,1,1,3
10242,s20837084,20837084,오고파미용타운,1,1,1,3
10243,s1378996104,1378996104,호박창고 미용실,1,1,1,3
10244,s20864382,20864382,진영헤어아트,1,1,1,3
10245,s1022765888,1022765888,쎄느헤어플러스,1,1,1,3
10246,s18599473,18599473,선정민헤어,1,1,1,3
10247,s1343051715,1343051715,더끌림헤어,1,1,1,3
10248,s1522592162,1522592162,이지원헤어,1,1,1,3
10249,s17907662,17907662,박정아헤어랜드,1,1,1,3
10250,s20932900,20932900,란헤어,1,1,1,3
10251,s1459818765,1459818765,헤어필,1,1,1,3
10252,s1778087679,1778087679,머리대장,1,1,1,3
10253,s31392277,31392277,센스헤어클럽,1,1,1,3
10254,s1829478961,1829478961,영헤어샵,1,1,1,3
10255,s18603903,18603903,김호숙헤어아트,1,1,1,3
10256,s36405956,36405956,마술가위,1,1,1,3
10257,s1496205011,1496205011,헤어체인지,1,1,1,3
10258,s1052231646,1052231646,햇살헤어샵,1,1,1,3
10259,s20841011,20841011,애자미용실,1,1,1,3
10260,s18600437,18600437,란헤어샵,1,1,1,3
10261,s1653564317,1653564317,조희숙헤어,1,1,1,3
10262,s1851614757,1851614757,란미용실,1,1,1,3
10263,s18602329,18602329,머리만들기,1,1,1,3
10264,s1663058936,1663058936,손수헤어,1,1,1,3
10265,s1077872563,1077872563,붐붐헤어,1,1,1,3
10266,s31655293,31655293,지지배배,1,1,1,3
10267,s34356114,34356114,동명헤어컷트전문,1,1,1,3
10268,s1807222659,1807222659,공주헤어샵,1,1,1,3
10269,s1051142307,1051142307,일신헤어테크,1,1,1,3
10270,s1076214711,1076214711,가위놀이,1,1,1,3
10271,s34350919,34350919,염색편의점삼양사거리점,1,1,1,3
10272,s1310701487,1310701487,제이앤비헤어샵,1,1,1,3
10273,s20868061,20868061,썬헤어클럽,1,1,1,3
10274,s1643144628,1643144628,댕기머리,1,1,1,3
10275,s18605547,18605547,세븐헤어모드,1,1,1,3
10276,s1747371447,1747371447,김민헤어샵,1,1,1,3
10277,s20844985,20844985,머리자리,1,1,1,3
10278,s1596985859,1596985859,샤넬헤어,1,1,1,3
10279,s20936877,20936877,진미용실,1,1,1,3
10280,s20868295,20868295,이현정헤어샵,1,1,1,3
10281,s20906460,20906460,헤어락,1,1,1,3
10282,s18612508,18612508,예진헤어,1,1,1,3
10283,s18611770,18611770,크리스핀헤어,1,1,1,3
10284,s1557373160,1557373160,영지헤어,1,1,1,3
10285,s34356237,34356237,아우라헤어,1,1,1,3
10286,s18608629,18608629,MJ헤어갤러리수유점,1,1,1,3
10287,s38951532,38951532,김현주 헤어,1,1,1,3
10288,s1208238302,1208238302,제이유헤어,1,1,1,3
10289,s37537398,37537398,젠헤어,1,1,1,3
10290,s916465635,916465635,수헤어,1,1,1,3
10291,s20864440,20864440,윤스킴헤어,1,1,1,3
10292,s1007485091,1007485091,에코헤어,1,1,1,3
10293,s19410252,19410252,박선영미용실,1,1,1,3
10294,s19477835,19477835,쥬신헤어 미아점,1,1,1,3
10295,s1209844676,1209844676,더볼륨헤어,1,1,1,3
10296,s1078133739,1078133739,507헤어살롱,1,1,1,3
10297,s1270287197,1270287197,명동미용실,1,1,1,3
10298,s1314792079,1314792079,헤어창조,1,1,1,3
10299,s1755543728,1755543728,헤어살롱끌림,1,1,1,3
10300,s1236157866,1236157866,세븐헤어아트,1,1,1,3
10301,s1070601604,1070601604,강경숙미용실,1,1,1,3
10302,s1006249743,1006249743,강경숙헤어숍,1,1,1,3
10303,s18615701,18615701,요술가위,1,1,1,3
10304,s1848491882,1848491882,강남스타일,1,1,1,3
10305,s1093475305,1093475305,헤어리,1,1,1,3
10306,s1140923403,1140923403,브이헤어,1,1,1,3
10307,s20879852,20879852,지헤어리더,1,1,1,3
10308,s18608968,18608968,머리손질헤어샵,1,1,1,3
10309,s18608341,18608341,비단머리방,1,1,1,3
10310,s34352545,34352545,이브헤어,1,1,1,3
10311,s36005202,36005202,머리하는집,1,1,1,3
10312,s1772368735,1772368735,여우깍쟁이,1,1,1,3
10313,s18608605,18608605,풍년미용실,1,1,1,3
10314,s20917842,20917842,쉬즈헤어갤러리,1,1,1,3
10315,s1432483155,1432483155,소희헤어,1,1,1,3
10316,s1162290504,1162290504,유명례헤어뷰티샵,1,1,1,3
10317,s1266699650,1266699650,강남스타일헤어,1,1,1,3
10318,s20841097,20841097,퀸헤어,1,1,1,3
10319,s1860566357,1860566357,하은미용실,1,1,1,3
10320,s36132983,36132983,헤어by봉,1,1,1,3
10321,s1027837311,1027837311,헤어카페감동,1,1,1,3
10322,s38511176,38511176,감성헤어 서울수유점,1,1,1,3
10323,s1038533580,1038533580,헤어수,1,1,1,3
10324,s1043469135,1043469135,설렘헤어,1,1,1,3
10325,s1381755694,1381755694,헤어클럽,1,1,1,3
10326,s18615819,18615819,가위잡이헤어,1,1,1,3
10327,s39825637,39825637,아델린,1,1,1,3
10328,s445667741,445667741,골목살롱,1,1,1,3
10329,s1940814658,1940814658,시크릿헤어,1,1,1,3
10330,s20872042,20872042,헤어밴드,1,1,1,3
10331,s1527647694,1527647694,다인헤어,1,1,1,3
10332,s20825405,20825405,승연헤어,1,1,1,3
10333,s1765090141,1765090141,신세대헤어클럽,1,1,1,3
10334,s1235299786,1235299786,하나미용타운,1,1,1,3
10335,s34354151,34354151,그레이스헤어스튜디오,1,1,1,3
10336,s17931974,17931974,마르떼미용실,1,1,1,3
10337,s1909439996,1909439996,플로라헤어,1,1,1,3
10338,s34353288,34353288,희정미용실,1,1,1,3
10339,s18605888,18605888,헤어제트,1,1,1,3
10340,s20936796,20936796,모라도헤어,1,1,1,3
10341,s1226441594,1226441594,마리헤어,1,1,1,3
10342,s1152077435,1152077435,마리헤어,1,1,1,3
10343,s1587494329,1587494329,빨간머리앤,1,1,1,3
10344,s1729001873,1729001873,설희미용실,1,1,1,3
10345,s1055711800,1055711800,J헤어,1,1,1,3
10346,s1756626247,1756626247,메이드바이제이헤어살롱,1,1,1,3
10347,s1502835804,1502835804,1329헤어스튜디오,1,1,1,3
10348,s1343065269,1343065269,조이헤어미용실,1,1,1,3
10349,s20883723,20883723,짱구머리,1,1,1,3
10350,s34353214,34353214,정샘헤어,1,1,1,3
10351,s1824134735,1824134735,가위쟁이,1,1,1,3
10352,s20891226,20891226,지지미용실,1,1,1,3
10353,s20833278,20833278,분홍미용실,1,1,1,3
10354,s1733028718,1733028718,제이에게 헤어샵,1,1,1,3
10355,s20921637,20921637,박민헤어,1,1,1,3
10356,s20936895,20936895,백궁미용실,1,1,1,3
10357,s20837225,20837225,정헤어,1,1,1,3
10358,s11694265,11694265,지영미용실,1,1,1,3
10359,s1208594824,1208594824,엘건헤어,1,1,1,3
10360,s18601805,18601805,머리하기좋은날,1,1,1,3
10361,s1530962028,1530962028,송헤어,1,1,1,3
10362,s1136566029,1136566029,근화미용실,1,1,1,3
10363,s20849020,20849020,대도헤어샵,1,1,1,3
10364,s20897557,20897557,가위소리미용실,1,1,1,3
10365,s34351360,34351360,천연머리염색헤어샵,1,1,1,3
10366,s18910667,18910667,유림헤어샵,1,1,1,3
10367,s18604825,18604825,헤어나인,1,1,1,3
10368,s32182595,32182595,헤어이미지,1,1,1,3
10369,s36413960,36413960,S헤어스토리,1,1,1,3
10370,s1281232360,1281232360,고센헤어,1,1,1,3
10371,s1948294248,1948294248,아띠헤어,1,1,1,3
10372,s1089620784,1089620784,보보헤어,1,1,1,3
10373,s18617314,18617314,라붐헤어아트,1,1,1,3
10374,s20852571,20852571,리치헤어,1,1,1,3
10375,s1183224885,1183224885,수잔헤어,1,1,1,3
10376,s38334551,38334551,써니헤어,1,1,1,3
10377,s1315410694,1315410694,한우리미용실,1,1,1,3
10378,s1199457787,1199457787,란헤어뱅크,1,1,1,3
10379,s38339087,38339087,린헤어,1,1,1,3
10380,s37520645,37520645,끼샵,1,1,1,3
10381,s1280815786,1280815786,골든R미용실,1,1,1,3
10382,s857075665,857075665,W shop,1,1,1,3
10383,s20929198,20929198,K2헤어팀,1,1,1,3
10384,s1170817771,1170817771,지인헤어,1,1,1,3
10385,s1011272574,1011272574,피앤제이헤어갤러리,1,1,1,3
10386,s944436340,944436340,마르떼헤어,1,1,1,3
10387,s1051751853,1051751853,더헤어,1,1,1,3
10388,s1293544973,1293544973,이경희노블헤어미용실,1,1,1,3
10389,s18600725,18600725,나빌레라,1,1,1,3
10390,sk1264875288,k1264875288,궁,1,1,1,3
10391,s18603542,18603542,코드네임제이제이,1,1,1,3
10392,s1295190251,1295190251,아이비헤어,1,1,1,3
10393,s1084011022,1084011022,플레로마 헤어,1,1,1,3
10394,s1482902783,1482902783,예원헤어샵,1,1,1,3
10395,s17949504,17949504,금하미용타운,1,1,1,3
10396,s20921439,20921439,미모헤어,1,1,1,3
10397,s11869827,11869827,무찌마헤어,1,1,1,3
10398,s1640424862,1640424862,헤어살롱오늘,1,1,1,3
10399,s38339070,38339070,마리헤어,1,1,1,3
10400,s1123810969,1123810969,젠틀맨,1,1,1,3
10401,s38479095,38479095,다비드헤어,1,1,1,3
10402,s1450012934,1450012934,주나헤어,1,1,1,3
10403,s1776237945,1776237945,주현희헤어샵,1,1,1,3
10404,s13484694,13484694,김지희머리사랑미용실,1,1,1,3
10405,s18610755,18610755,요술가위,1,1,1,3
10406,s1338362408,1338362408,슈슈헤어,1,1,1,3
10407,s20929297,20929297,남정숙헤어스케치,1,1,1,3
10408,s1285303846,1285303846,명희뷰티랩,1,1,1,3
10409,s1420118294,1420118294,수지미용실,1,1,1,3
10410,s20868081,20868081,해피데이,1,1,1,3
10411,s20879748,20879748,머리뱅크,1,1,1,3
10412,s1217334945,1217334945,헤어매니아,1,1,1,3
10413,s1815277494,1815277494,코코헤어,1,1,1,3
10414,s1251776087,1251776087,주헤어,1,1,1,3
10415,s13414188,13414188,스타헤어삼양점,1,1,1,3
10416,s1926910999,1926910999,서현미용실,1,1,1,3
10417,s18599295,18599295,까까머리미용실,1,1,1,3
10418,s1188303082,1188303082,2리오,1,1,1,3
10419,s18608483,18608483,주해성미용실,1,1,1,3
10420,s1291057472,1291057472,윤선헤어,1,1,1,3
10421,s17910052,17910052,쉬에뜨헤어,1,1,1,3
10422,s1484104393,1484104393,하나미용실,1,1,1,3
10423,s38705392,38705392,에반헤어,1,1,1,3
10424,s1014865021,1014865021,쥬리아미용실,1,1,1,3
10425,s1411253742,1411253742,수빈헤어스타일,1,1,1,3
10426,s1184452700,1184452700,도도헤어,1,1,1,3
10427,s1002074005,1002074005,이미정헤어,1,1,1,3
10428,s1053724160,1053724160,박인희헤어,1,1,1,3
10429,s1030272515,1030272515,예주미용실,1,1,1,3
10430,s1949352087,1949352087,소은자헤어마트,1,1,1,3
10431,s1490717861,1490717861,소은자헤어아트칼라,1,1,1,3
10432,s1946626946,1946626946,헤어컷,1,1,1,3
10433,s20835489,20835489,정헤어샵,1,1,1,3
10434,s1483065289,1483065289,료마살롱,1,1,1,3
10435,s1917118264,1917118264,에덴칼라시대,1,1,1,3
10436,s34289153,34289153,라임헤어,1,1,1,3
10437,s1803413059,1803413059,J헤어,1,1,1,3
10438,s18601123,18601123,나나헤어살롱,1,1,1,3
10439,s1199365197,1199365197,이인숙헤어클럽,1,1,1,3
10440,s1745862423,1745862423,진헤어갤러리,1,1,1,3
10441,s17945780,17945780,헤어마을,1,1,1,3
10442,s1355551146,1355551146,두리헤어라인,1,1,1,3
10443,s1555227626,1555227626,Therapy헤어,1,1,1,3
10444,s1255432126,1255432126,테라피헤어,1,1,1,3
10445,s20825349,20825349,머리가예쁜사람들,1,1,1,3
10446,s20887482,20887482,샬롬미용실,1,1,1,3
10447,s20841061,20841061,까망헤어,1,1,1,3
10448,s37064840,37064840,원헤어,1,1,1,3
10449,s19754077,19754077,파라포라,1,1,1,3
10450,s18256804,18256804,머리가연희점,1,1,1,3
10451,s18710191,18710191,정희영헤어파라팜,1,1,1,3
10452,s488831643,488831643,열세븐헤어신대방삼거리역점,1,1,1,3
10453,s1735592775,1735592775,이혜련뷰티퀸,1,1,1,3
10454,s1545469724,1545469724,제일미용타운,1,1,1,3
10455,s1170328231,1170328231,정아미용실,1,1,1,3
10456,s1348155730,1348155730,신수정헤어뉴스,1,1,1,3
10457,s85655673,85655673,순이미장,1,1,1,3
10458,s973973964,973973964,머링헤어,1,1,1,3
10459,s20899679,20899679,머리하기,1,1,1,3
10460,s32114864,32114864,머리나라미용실,1,1,1,3
10461,s20880673,20880673,원미용실,1,1,1,3
10462,s31729318,31729318,킴스헤어라인,1,1,1,3
10463,s18745109,18745109,아림미용실,1,1,1,3
10464,s20853659,20853659,영미용실,1,1,1,3
10465,s21219488,21219488,리오헤어,1,1,1,3
10466,s1674917686,1674917686,나이스가이 장승배기역점,1,1,1,3
10467,s1893229490,1893229490,르메이헤어 노량진점,1,1,1,3
10468,s11559577,11559577,가시버시미용실,1,1,1,3
10469,s20995699,20995699,장선헤어,1,1,1,3
10470,s1144852684,1144852684,epda,1,1,1,3
10471,sk18751618,k18751618,아까르마미용실,1,1,1,3
10472,s19026276,19026276,우리미용실,1,1,1,3
10473,s20857376,20857376,신지헤어샵,1,1,1,3
10474,s1344786104,1344786104,한혜선미용실,1,1,1,3
10475,s1195161367,1195161367,수정미용실,1,1,1,3
10476,s1802979101,1802979101,보영헤어,1,1,1,3
10477,s34616324,34616324,오라헤어,1,1,1,3
10478,s1247472809,1247472809,미스터헤어컷,1,1,1,3
10479,s20888391,20888391,미즈미용실,1,1,1,3
10480,s19026277,19026277,성대헤어,1,1,1,3
10481,s20911100,20911100,조이헤어샾,1,1,1,3
10482,s1258858281,1258858281,김성희헤어명가,1,1,1,3
10483,s158173513,158173513,에덴미용실,1,1,1,3
10484,s1183814514,1183814514,카리스미용실,1,1,1,3
10485,s19023508,19023508,신미선헤어모드,1,1,1,3
10486,s508427383,508427383,유행머리,1,1,1,3
10487,s20868985,20868985,우진미용실,1,1,1,3
10488,s40469217,40469217,수놓은염색 상도점,1,1,1,3
10489,s38561165,38561165,미랑컬헤어 신대방삼거리역점,1,1,1,3
10490,s20899607,20899607,머리나라,1,1,1,3
10491,s19027030,19027030,김시연헤어샵,1,1,1,3
10492,s20922546,20922546,유호정미용실,1,1,1,3
10493,s1855372059,1855372059,칼라피플,1,1,1,3
10494,s514432827,514432827,쉔미용실,1,1,1,3
10495,s1003722270,1003722270,진헤어,1,1,1,3
10496,s19020289,19020289,삼화미용실,1,1,1,3
10497,s38531532,38531532,지니헤어,1,1,1,3
10498,s1007045782,1007045782,신경화미용실,1,1,1,3
10499,s20865273,20865273,본동미용실,1,1,1,3
10500,s914175043,914175043,진헤어샵,1,1,1,3
10501,s252224412,252224412,예랑헤어샾,1,1,1,3
10502,s846921880,846921880,에덴헤어,1,1,1,3
10503,s20826438,20826438,박정자헤어샵,1,1,1,3
10504,s738121160,738121160,버르장머리,1,1,1,3
10505,s20869108,20869108,낙향헤어샵,1,1,1,3
10506,s20892209,20892209,까치미용실,1,1,1,3
10507,s1225480526,1225480526,유호정미용실,1,1,1,3
10508,s19027146,19027146,주영머리방,1,1,1,3
10509,s18762623,18762623,차밍미용실,1,1,1,3
10510,s20872780,20872780,챠밍헤어샵,1,1,1,3
10511,s661627198,661627198,윤아미용실,1,1,1,3
10512,s18723308,18723308,가든미용실,1,1,1,3
10513,s271850633,271850633,우정미용실,1,1,1,3
10514,s1991394698,1991394698,신유머리방,1,1,1,3
10515,s18764029,18764029,이정미용실,1,1,1,3
10516,s38453885,38453885,살롱에이 중대2호점,1,1,1,3
10517,s199978679,199978679,뉴헤어스케치,1,1,1,3
10518,s681822767,681822767,다올미용실,1,1,1,3
10519,s996708823,996708823,산미용실,1,1,1,3
10520,s19019812,19019812,수영미용실,1,1,1,3
10521,s20907428,20907428,해바라기,1,1,1,3
10522,s19020962,19020962,유정미용실,1,1,1,3
10523,s1897297632,1897297632,문세실리아헤어샵,1,1,1,3
10524,s20876964,20876964,아름미용실,1,1,1,3
10525,s20865183,20865183,유연경헤어,1,1,1,3
10526,s964015708,964015708,J&J헤어,1,1,1,3
10527,s18692352,18692352,코코미용실,1,1,1,3
10528,s98438614,98438614,문미용실,1,1,1,3
10529,s1160734747,1160734747,명동미장,1,1,1,3
10530,s20905458,20905458,엄청난미용실,1,1,1,3
10531,s18753617,18753617,박성준헤어캅스,1,1,1,3
10532,s1687589336,1687589336,이서영헤어샵,1,1,1,3
10533,s1599284060,1599284060,우리미용실,1,1,1,3
10534,s1550964366,1550964366,헤어센스,1,1,1,3
10535,s20899662,20899662,헤어아트,1,1,1,3
10536,s1250234973,1250234973,은혜미용실,1,1,1,3
10537,s1347221246,1347221246,정애정 헤어스토리,1,1,1,3
10538,s110695921,110695921,코코헤어샵,1,1,1,3
10539,s1416328296,1416328296,숙미용실,1,1,1,3
10540,s1044346465,1044346465,e끌림헤어샵,1,1,1,3
10541,s37486836,37486836,구피샵 성대시장점,1,1,1,3
10542,s1259823700,1259823700,살롱드90,1,1,1,3
10543,s1097306443,1097306443,위드헤어,1,1,1,3
10544,s1326311002,1326311002,김소정헤어,1,1,1,3
10545,s1572354099,1572354099,지원헤어샵,1,1,1,3
10546,s20846969,20846969,압구정헤어,1,1,1,3
10547,s1189551092,1189551092,까미헤어,1,1,1,3
10548,s1032578624,1032578624,모니카헤어,1,1,1,3
10549,s35727127,35727127,Y HAIR,1,1,1,3
10550,s1011504294,1011504294,김정희힐링헤어,1,1,1,3
10551,s37078422,37078422,어린왕자 헤어샾,1,1,1,3
10552,s1921145375,1921145375,엔비헤어,1,1,1,3
10553,s1800369449,1800369449,리치헤어,1,1,1,3
10554,s36637960,36637960,샤인헤어,1,1,1,3
10555,s1290604118,1290604118,민헤어,1,1,1,3
10556,s1607432364,1607432364,미고헤어,1,1,1,3
10557,s37108396,37108396,L GUN HAIR,1,1,1,3
10558,s1613922206,1613922206,샤이니헤어,1,1,1,3
10559,s1187975050,1187975050,마릴린헤어,1,1,1,3
10560,s37454782,37454782,HAIR지지말자,1,1,1,3
10561,s1605065468,1605065468,별하헤어샵,1,1,1,3
10562,s1877053197,1877053197,댄디보이,1,1,1,3
10563,s1522476404,1522476404,하랑헤어,1,1,1,3
10564,s1459939807,1459939807,오땡큐 휘경동점,1,1,1,3
10565,s1000265103,1000265103,헤어살롱 레뇨,1,1,1,3
10566,s38305594,38305594,꽃내음언니,1,1,1,3
10567,s36285830,36285830,수연헤어팜,1,1,1,3
10568,s21300064,21300064,나나헤어,1,1,1,3
10569,s1169004776,1169004776,아르떼헤어,1,1,1,3
10570,sk1038163989,k1038163989,헤어마루,1,1,1,3
10571,s1747508139,1747508139,연헤어,1,1,1,3
10572,s31051249,31051249,태후사랑 전농점,1,1,1,3
10573,s1921116200,1921116200,아뜰리에하루,1,1,1,3
10574,s1418210025,1418210025,아린헤어,1,1,1,3
10575,s1866923360,1866923360,예쁜머리방,1,1,1,3
10576,s34087249,34087249,기분좋은날,1,1,1,3
10577,s1256024798,1256024798,S헤어,1,1,1,3
10578,s1113057814,1113057814,까까머리,1,1,1,3
10579,s1237182963,1237182963,예쁜머리,1,1,1,3
10580,s1739991472,1739991472,루이헤어,1,1,1,3
10581,s34582447,34582447,JJ헤어,1,1,1,3
10582,s35560164,35560164,다인헤어,1,1,1,3
10583,s1912814718,1912814718,오땡큐 전농점,1,1,1,3
10584,s1541336804,1541336804,나비헤어,1,1,1,3
10585,s35338577,35338577,구피샵 휘경점,1,1,1,3
10586,s1846941111,1846941111,민헤어,1,1,1,3
10587,s20923301,20923301,태후사랑장안1호점,1,1,1,3
10588,s38510862,38510862,JIN헤어,1,1,1,3
10589,s1444814551,1444814551,러블리헤어샵,1,1,1,3
10590,s1522777049,1522777049,미장원 by ms,1,1,1,3
10591,s20835034,20835034,서주희헤어,1,1,1,3
10592,s1488649553,1488649553,헬로우컷  동대문전농점,1,1,1,3
10593,s1249791233,1249791233,수반리헤어,1,1,1,3
10594,s1093875339,1093875339,H헤어,1,1,1,3
10595,s1861578456,1861578456,토브헤어,1,1,1,3
10596,s1638739919,1638739919,원수연 미용실,1,1,1,3
10597,s1281704933,1281704933,더 좋은 헤어,1,1,1,3
10598,s1504849238,1504849238,살롱드마리,1,1,1,3
10599,s1472976139,1472976139,더어반헤어,1,1,1,3
10600,s1115967252,1115967252,컷앤펌,1,1,1,3
10601,s1702088024,1702088024,헤어플로렌스,1,1,1,3
10602,s1453836463,1453836463,더 무드 헤어,1,1,1,3
10603,s873159017,873159017,대원미용실,1,1,1,3
10604,s1361814232,1361814232,박미용실,1,1,1,3
10605,s20905466,20905466,이정은미용실,1,1,1,3
10606,s1458257999,1458257999,루시아 헤어,1,1,1,3
10607,s77944622,77944622,헤어붐,1,1,1,3
10608,s428479181,428479181,헤어디자이너,1,1,1,3
10609,s19025069,19025069,행복한미용실,1,1,1,3
10610,s939542079,939542079,안쌤헤어,1,1,1,3
10611,s13555723,13555723,로사헤어,1,1,1,3
10612,s1484052948,1484052948,태후사랑 전농점,1,1,1,3
10613,s1506826242,1506826242,더설렘뷰티하우스,1,1,1,3
10614,s1169686820,1169686820,좋은날헤어,1,1,1,3
10615,s333591437,333591437,별헤어&네일,1,1,1,3
10616,s13548661,13548661,나비헤어,1,1,1,3
10617,s13398932,13398932,배은지스타일리스트,1,1,1,3
10618,s1806213947,1806213947,올리비아헤어,1,1,1,3
10619,s981080141,981080141,헤어룸,1,1,1,3
10620,s392685120,392685120,호선생,1,1,1,3
10621,s51373431,51373431,더렘헤어,1,1,1,3
10622,s1149825413,1149825413,헤어블링,1,1,1,3
10623,s35807327,35807327,민헤어살롱,1,1,1,3
10624,s1501273982,1501273982,더감동헤어,1,1,1,3
10625,s20870047,20870047,수헤어클럽,1,1,1,3
10626,s1338295751,1338295751,김현정헤어,1,1,1,3
10627,s1980487481,1980487481,에델 헤어,1,1,1,3
10628,s38667200,38667200,도도헤어,1,1,1,3
10629,s37615393,37615393,태후사랑 휘경2호점,1,1,1,3
10630,s1844940249,1844940249,현 헤어샵,1,1,1,3
10631,s1731576768,1731576768,하루앤노아,1,1,1,3
10632,s1881109946,1881109946,MOMO SALON 1호점,1,1,1,3
10633,s1624137916,1624137916,수복미용실,1,1,1,3
10634,s19030947,19030947,마샬헤어샵,1,1,1,3
10635,s20830460,20830460,이화미용실,1,1,1,3
10636,s1810633656,1810633656,머리하는날,1,1,1,3
10637,s20918567,20918567,헤어준,1,1,1,3
10638,s11574650,11574650,김동휘헤어콜렉션,1,1,1,3
10639,s18763231,18763231,개성시대,1,1,1,3
10640,s18756194,18756194,이주헤어커커,1,1,1,3
10641,s11729912,11729912,블루클럽 상도역점,1,1,1,3
10642,s20892046,20892046,투나헤어모델,1,1,1,3
10643,s18745859,18745859,우성아트헤어,1,1,1,3
10644,s18751633,18751633,숙미용실,1,1,1,3
10645,s20933815,20933815,TIJI2,1,1,1,3
10646,s18723319,18723319,임마누엘프로헤어,1,1,1,3
10647,s1301764484,1301764484,더블유 헤어,1,1,1,3
10648,s1919111770,1919111770,헤어코디,1,1,1,3
10649,s740950515,740950515,신데렐라헤어샵,1,1,1,3
10650,s248406106,248406106,윤비헤어,1,1,1,3
10651,s19034038,19034038,하비비헤어샵,1,1,1,3
10652,s20911274,20911274,이즈헤어커커,1,1,1,3
10653,s20838202,20838202,민선영헤어샵,1,1,1,3
10654,s1703946804,1703946804,헤어20J,1,1,1,3
10655,s1027475917,1027475917,더파인드헤어,1,1,1,3
10656,s19037969,19037969,뉴헤어클럽,1,1,1,3
10657,s354748024,354748024,허밍미용실,1,1,1,3
10658,s1168819652,1168819652,비비드헤어,1,1,1,3
10659,s13156812,13156812,진경헤어샵,1,1,1,3
10660,s19032460,19032460,삼미헤어샵,1,1,1,3
10661,s652524009,652524009,밀리오레헤어클럽,1,1,1,3
10662,s18710185,18710185,조현호미용실,1,1,1,3
10663,s20857485,20857485,이현남헤어모드,1,1,1,3
10664,s1149225250,1149225250,헤어바이미루,1,1,1,3
10665,s19025981,19025981,머리사랑,1,1,1,3
10666,s1090797799,1090797799,염색사랑,1,1,1,3
10667,s20846041,20846041,헤어클럽제이,1,1,1,3
10668,s1305316409,1305316409,헤어J,1,1,1,3
10669,s251031079,251031079,댕기머리미용실,1,1,1,3
10670,s20930207,20930207,이찌헤어카락,1,1,1,3
10671,s20826559,20826559,머리하는날,1,1,1,3
10672,s1063704942,1063704942,헤어피플,1,1,1,3
10673,s19037332,19037332,골드헤어라인,1,1,1,3
10674,s19035003,19035003,주정란헤어써클,1,1,1,3
10675,s38544660,38544660,이정윤 헤어샵,1,1,1,3
10676,s330270135,330270135,한지희헤어샵,1,1,1,3
10677,s1037370762,1037370762,K헤어,1,1,1,3
10678,s20845814,20845814,평강공주헤어샾,1,1,1,3
10679,s1525294089,1525294089,컨헤어살롱,1,1,1,3
10680,s19032999,19032999,살롱드비비드,1,1,1,3
10681,s31400911,31400911,우리들미용실,1,1,1,3
10682,s19034216,19034216,끼각끼,1,1,1,3
10683,s32253290,32253290,유민희헤어라인,1,1,1,3
10684,s442346896,442346896,머리이야기,1,1,1,3
10685,s1133168253,1133168253,환희헤어샵,1,1,1,3
10686,s20865311,20865311,실디미용실,1,1,1,3
10687,s547861476,547861476,택시헤어,1,1,1,3
10688,s12974249,12974249,최가을헤어드레서 숭실대점,1,1,1,3
10689,s1288557425,1288557425,살롱드 5K헤어,1,1,1,3
10690,s37690487,37690487,구피샵 상도점,1,1,1,3
10691,s1616476618,1616476618,코코헤어,1,1,1,3
10692,s18699235,18699235,지플랜헤어,1,1,1,3
10693,s36727611,36727611,윤설헤어,1,1,1,3
10694,s1122326580,1122326580,루비헤어,1,1,1,3
10695,s1294955502,1294955502,정민헤어,1,1,1,3
10696,s1481027470,1481027470,배석헤어,1,1,1,3
10697,s1542305076,1542305076,필헤어테크,1,1,1,3
10698,s37799330,37799330,M헤어,1,1,1,3
10699,s31664270,31664270,단발머리미용실,1,1,1,3
10700,s1146563142,1146563142,머리하는고양이,1,1,1,3
10701,s20888187,20888187,휴헤어샵,1,1,1,3
10702,s722407224,722407224,다온헤어샾,1,1,1,3
10703,s20675851,20675851,나비효과,1,1,1,3
10704,s35092085,35092085,헤어스토리,1,1,1,3
10705,s1521857470,1521857470,예쁠래,1,1,1,3
10706,s31729835,31729835,수연헤어샵,1,1,1,3
10707,s960712275,960712275,라파헤어,1,1,1,3
10708,s1135771514,1135771514,헤어미술관,1,1,1,3
10709,s557204911,557204911,라인샾,1,1,1,3
10710,s1880568440,1880568440,컷앤컬,1,1,1,3
10711,s1046889472,1046889472,송재원헤어샵,1,1,1,3
10712,s20738823,20738823,이수헤어,1,1,1,3
10713,s337180113,337180113,카라헤어,1,1,1,3
10714,s20822381,20822381,수연헤어,1,1,1,3
10715,s826497996,826497996,헤어탑팀이수점,1,1,1,3
10716,s1701711029,1701711029,이채영헤어,1,1,1,3
10717,s18723217,18723217,귀빈미용실,1,1,1,3
10718,s1119352445,1119352445,미니헤어,1,1,1,3
10719,s1984483884,1984483884,이한혜어샵,1,1,1,3
10720,s18380882,18380882,맘모스,1,1,1,3
10721,s31182809,31182809,헤어핀,1,1,1,3
10722,s1592284762,1592284762,헤어컴미용실,1,1,1,3
10723,s19952442,19952442,머리코디,1,1,1,3
10724,s21530298,21530298,A865 HAIR,1,1,1,3
10725,s20834178,20834178,나래헤어커커,1,1,1,3
10726,s19030814,19030814,예림미용실,1,1,1,3
10727,s1048064943,1048064943,빗과결사이,1,1,1,3
10728,s1784478367,1784478367,강지연헤어샵,1,1,1,3
10729,s20914909,20914909,조혜정헤어아트,1,1,1,3
10730,s20880736,20880736,우리미용실,1,1,1,3
10731,s20830361,20830361,열린헤어샵,1,1,1,3
10732,s20880713,20880713,지나헤어샾,1,1,1,3
10733,s18716385,18716385,현희미용실,1,1,1,3
10734,s870243022,870243022,청담헤어갤러리,1,1,1,3
10735,s20838136,20838136,현의미용타운,1,1,1,3
10736,s20884517,20884517,샤론헤어샵,1,1,1,3
10737,s20708230,20708230,엠와이헤어매니아,1,1,1,3
10738,s1779749149,1779749149,나성헤어뱅크,1,1,1,3
10739,s20880737,20880737,미즈홍헤어샵,1,1,1,3
10740,s19565682,19565682,한강미용실,1,1,1,3
10741,s1220637925,1220637925,헤어오페라미용실,1,1,1,3
10742,s315124634,315124634,김화경머리사랑,1,1,1,3
10743,s19836310,19836310,수아미용실,1,1,1,3
10744,s19542119,19542119,헤어이미지메이킹,1,1,1,3
10745,s19029882,19029882,수아헤어뷰티팜,1,1,1,3
10746,s1735976050,1735976050,BH헤어샵,1,1,1,3
10747,s1967761873,1967761873,국제미용실,1,1,1,3
10748,s1237334507,1237334507,깐느헤어클럽,1,1,1,3
10749,s1709492427,1709492427,메이드인헤어,1,1,1,3
10750,s188604702,188604702,21세기미용실,1,1,1,3
10751,s945969122,945969122,현대헤어컷트,1,1,1,3
10752,s1110084491,1110084491,지윤헤어모드,1,1,1,3
10753,s20926171,20926171,스타미용실,1,1,1,3
10754,s20846021,20846021,태양미용실,1,1,1,3
10755,s19019523,19019523,머리여행,1,1,1,3
10756,s1973296337,1973296337,오드리헵번,1,1,1,3
10757,s18706095,18706095,한스헤어,1,1,1,3
10758,s20872919,20872919,머리하는미용실,1,1,1,3
10759,s20822396,20822396,안나미용실,1,1,1,3
10760,s20822196,20822196,사랑새헤어클럽,1,1,1,3
10761,s1699034128,1699034128,희싸롱,1,1,1,3
10762,s13436046,13436046,스타일리스트,1,1,1,3
10763,s31850226,31850226,이민희헤어,1,1,1,3
10764,s35873867,35873867,구피샵 흑석점,1,1,1,3
10765,s1622059996,1622059996,마마헤어,1,1,1,3
10766,s21791044,21791044,비비헤어,1,1,1,3
10767,s18715920,18715920,버르짱머리,1,1,1,3
10768,s11459667,11459667,푸러마러,1,1,1,3
10769,s1453914604,1453914604,오페라미용실,1,1,1,3
10770,s20865234,20865234,헤어코코,1,1,1,3
10771,s1649628793,1649628793,마샬헤어,1,1,1,3
10772,s19030640,19030640,수자미용실,1,1,1,3
10773,s19028116,19028116,정헤어스토리,1,1,1,3
10774,s1830440741,1830440741,머리치장,1,1,1,3
10775,s20918602,20918602,별헤어샵,1,1,1,3
10776,s1999985865,1999985865,권수현헤어클릭,1,1,1,3
10777,s1948190705,1948190705,다은헤어샵,1,1,1,3
10778,s18737907,18737907,조수현헤어라인,1,1,1,3
10779,s18762618,18762618,김민희헤어클럽,1,1,1,3
10780,s19028595,19028595,정아헤어샵,1,1,1,3
10781,s13076934,13076934,이슈헤어,1,1,1,3
10782,s20926320,20926320,란미용실,1,1,1,3
10783,s19032379,19032379,준호헤어샵,1,1,1,3
10784,s1132907146,1132907146,지오헤어샵,1,1,1,3
10785,s554494165,554494165,샤넬미용실,1,1,1,3
10786,s1286332260,1286332260,세희미용실,1,1,1,3
10787,s876347241,876347241,변신하는날미용실,1,1,1,3
10788,s20849689,20849689,무지개헤어샵,1,1,1,3
10789,s1415700748,1415700748,헤어리제,1,1,1,3
10790,s1660323381,1660323381,민들레미용실,1,1,1,3
10791,s19033708,19033708,씨에프헤어클럽,1,1,1,3
10792,s19022210,19022210,영헤어샵,1,1,1,3
10793,s565274636,565274636,명동쥬리미용실,1,1,1,3
10794,s1992589982,1992589982,정숙자헤어샵,1,1,1,3
10795,s32116430,32116430,로즈헤어클럽,1,1,1,3
10796,s19032360,19032360,핑크헤어,1,1,1,3
10797,s19038170,19038170,헤어플러스,1,1,1,3
10798,s673488680,673488680,가위손미용실,1,1,1,3
10799,s1816478588,1816478588,이인선헤어센스,1,1,1,3
10800,s403387341,403387341,반달미용실,1,1,1,3
10801,s19036298,19036298,이브헤어샵,1,1,1,3
10802,s18721087,18721087,엄영희미용타운,1,1,1,3
10803,s20849711,20849711,황설아미용실,1,1,1,3
10804,s20903434,20903434,제일미용실,1,1,1,3
10805,s580465113,580465113,장은헤어샾,1,1,1,3
10806,s31400029,31400029,연지미용실,1,1,1,3
10807,s1698986448,1698986448,캐피탈미용실,1,1,1,3
10808,s18708067,18708067,헤어칼라,1,1,1,3
10809,s1556944828,1556944828,황실헤어라인,1,1,1,3
10810,s20826541,20826541,소망미용실,1,1,1,3
10811,s20918773,20918773,푸르나미용실,1,1,1,3
10812,s1515632460,1515632460,미소헤어,1,1,1,3
10813,s1828906879,1828906879,헤어뉴스,1,1,1,3
10814,s19029282,19029282,예감헤어 흑석점,1,1,1,3
10815,s19032544,19032544,도희헤어샵,1,1,1,3
10816,s20838274,20838274,루비오19000미용실신대방점,1,1,1,3
10817,s31131204,31131204,폭탄머리 장안점,1,1,1,3
10818,s1884657658,1884657658,김진헤어샵,1,1,1,3
10819,s18015195,18015195,이계임미용실,1,1,1,3
10820,s20896883,20896883,헤어제니스,1,1,1,3
10821,s1959174310,1959174310,꽃샘헤어클럽,1,1,1,3
10822,s18855583,18855583,규비헤어샾,1,1,1,3
10823,s20938558,20938558,박순자미용실,1,1,1,3
10824,s18045480,18045480,리안헤어 제기점,1,1,1,3
10825,s20900492,20900492,성희헤어라인,1,1,1,3
10826,s21002912,21002912,브니엘,1,1,1,3
10827,s1759827754,1759827754,진헤어샾,1,1,1,3
10828,s20842859,20842859,한아름헤어,1,1,1,3
10829,s20873761,20873761,티타니헤어센스,1,1,1,3
10830,s1066715857,1066715857,모드니헤어,1,1,1,3
10831,s1576395654,1576395654,이난미헤어,1,1,1,3
10832,s1529674975,1529674975,원헤어샵,1,1,1,3
10833,s20919666,20919666,진희헤어갤러리,1,1,1,3
10834,s20831241,20831241,정훈미용실,1,1,1,3
10835,s20923513,20923513,엘가모헤어,1,1,1,3
10836,s20885449,20885449,샤인헤어,1,1,1,3
10837,s1962454802,1962454802,에일린헤어,1,1,1,3
10838,s1362564124,1362564124,하경혜헤어스토리,1,1,1,3
10839,s20889152,20889152,댕기헤어클럽,1,1,1,3
10840,s1102403159,1102403159,샤닐헤어,1,1,1,3
10841,s1845135587,1845135587,버블헤어샵,1,1,1,3
10842,s1819901039,1819901039,코디헤어,1,1,1,3
10843,s1791328981,1791328981,귀빈미용타운,1,1,1,3
10844,sk18099921,k18099921,향미용실,1,1,1,3
10845,s18117197,18117197,하하미용실,1,1,1,3
10846,s1122188453,1122188453,바우헤어,1,1,1,3
10847,s18864282,18864282,개성시대,1,1,1,3
10848,s18842188,18842188,미소미용실,1,1,1,3
10849,s20862179,20862179,진미용실,1,1,1,3
10850,s1215239400,1215239400,뉴헤어모드,1,1,1,3
10851,s474425993,474425993,정현헤어마트,1,1,1,3
10852,s20938792,20938792,호수미용실,1,1,1,3
10853,s20892995,20892995,김희정미용실,1,1,1,3
10854,s1100534712,1100534712,쁨헤어,1,1,1,3
10855,s20472158,20472158,S1헤어,1,1,1,3
10856,s20931084,20931084,윤경희헤어샵,1,1,1,3
10857,s1907954623,1907954623,정은헤어라인,1,1,1,3
10858,s1031792905,1031792905,서울미용실,1,1,1,3
10859,s20904447,20904447,헤어메머리,1,1,1,3
10860,s1348932776,1348932776,귀빈미용실,1,1,1,3
10861,s1702575487,1702575487,탑헤어스케치,1,1,1,3
10862,s1452402925,1452402925,오케이미용실,1,1,1,3
10863,s18099924,18099924,변영미헤어샵,1,1,1,3
10864,s20831413,20831413,한성헤어샵,1,1,1,3
10865,s18118586,18118586,뷰티오즈,1,1,1,3
10866,s20915956,20915956,새로와헤어라인,1,1,1,3
10867,s1756086473,1756086473,탈랜트미용실,1,1,1,3
10868,s11554141,11554141,임혜진헤어,1,1,1,3
10869,s1827655038,1827655038,조아라미용실,1,1,1,3
10870,s18842126,18842126,허소영헤어,1,1,1,3
10871,s20881770,20881770,보람미용실,1,1,1,3
10872,s20843064,20843064,미헤어라인,1,1,1,3
10873,s20931048,20931048,숙이미용실,1,1,1,3
10874,s20911967,20911967,대형미용실,1,1,1,3
10875,s253121684,253121684,조은선헤어,1,1,1,3
10876,s1190914786,1190914786,영미용실,1,1,1,3
10877,s13166566,13166566,헤어닥터,1,1,1,3
10878,s32092147,32092147,빨간여우헤어컬렉션,1,1,1,3
10879,s20846936,20846936,이진미용실,1,1,1,3
10880,s1112691878,1112691878,이영란헤어두피전문,1,1,1,3
10881,s20850770,20850770,참참참헤어크리닉,1,1,1,3
10882,s33345624,33345624,도도헤어라인,1,1,1,3
10883,s20908357,20908357,귀빈헤어샵,1,1,1,3
10884,s1149596961,1149596961,나래헤어샵,1,1,1,3
10885,s20827268,20827268,새로나헤어,1,1,1,3
10886,s1699137173,1699137173,주희헤어,1,1,1,3
10887,s18854124,18854124,샤론헤어샵,1,1,1,3
10888,s18070112,18070112,까르띠미용실,1,1,1,3
10889,s20846888,20846888,전정아헤어클럽,1,1,1,3
10890,s213801767,213801767,코코헤어,1,1,1,3
10891,s18860758,18860758,석헤어숍,1,1,1,3
10892,s1913529796,1913529796,오 헤어,1,1,1,3
10893,s18115462,18115462,헤어월드,1,1,1,3
10894,s18084274,18084274,최민우헤어비젼,1,1,1,3
10895,s37427356,37427356,진달래 미용실,1,1,1,3
10896,s18118589,18118589,머리이야기미용실,1,1,1,3
10897,s20877741,20877741,한신머리방,1,1,1,3
10898,s20908356,20908356,토탈헤어뱅크,1,1,1,3
10899,s20873803,20873803,돌머리방,1,1,1,3
10900,s20885393,20885393,경아미용실,1,1,1,3
10901,s20908176,20908176,투투미용실,1,1,1,3
10902,s20912109,20912109,태양미용실,1,1,1,3
10903,s20827478,20827478,김양자헤어스케치,1,1,1,3
10904,s1337689152,1337689152,가위소리헤어,1,1,1,3
10905,s20896821,20896821,상원미용실,1,1,1,3
10906,s20831464,20831464,요술가위,1,1,1,3
10907,s18108162,18108162,수헤어,1,1,1,3
10908,s19410952,19410952,미헤어코리아,1,1,1,3
10909,s1020810500,1020810500,서명옥헤어샵,1,1,1,3
10910,s20862275,20862275,유림헤어프라자,1,1,1,3
10911,s1386023546,1386023546,민주헤어,1,1,1,3
10912,s1962905365,1962905365,미모헤어,1,1,1,3
10913,s20843033,20843033,태양헤어,1,1,1,3
10914,s20885390,20885390,가위든여자,1,1,1,3
10915,s1900868669,1900868669,현헤어,1,1,1,3
10916,s18084279,18084279,박영자미용실,1,1,1,3
10917,s20827343,20827343,진성미용실,1,1,1,3
10918,s20870072,20870072,머리사랑,1,1,1,3
10919,s18095371,18095371,뽀르떼미용실,1,1,1,3
10920,s20896753,20896753,은주헤어뉴스,1,1,1,3
10921,s1108548771,1108548771,다복미용실,1,1,1,3
10922,s18861307,18861307,임지영헤어샵,1,1,1,3
10923,s34105592,34105592,라브리지헤어샬롱 답십리역점,1,1,1,3
10924,s1066481790,1066481790,상희헤어,1,1,1,3
10925,s20919460,20919460,이경희미용실,1,1,1,3
10926,s20904254,20904254,유일미용실,1,1,1,3
10927,s20938708,20938708,선화미용실,1,1,1,3
10928,s1493238471,1493238471,헤어준,1,1,1,3
10929,s1190129128,1190129128,현주헤나헤어샵,1,1,1,3
10930,s20835220,20835220,이나영헤어,1,1,1,3
10931,s1276189395,1276189395,제임스리미용실,1,1,1,3
10932,s18108530,18108530,아라헤어샵 전농점,1,1,1,3
10933,s1575772233,1575772233,새롬미용실,1,1,1,3
10934,s20873963,20873963,은혜미용실,1,1,1,3
10935,s1335103186,1335103186,아름헤어,1,1,1,3
10936,s1043788366,1043788366,이안헤어,1,1,1,3
10937,s19782180,19782180,경희미용실,1,1,1,3
10938,s20850782,20850782,지니헤어,1,1,1,3
10939,s1885245827,1885245827,우주미용실,1,1,1,3
10940,s1271004597,1271004597,쎄븐미용실,1,1,1,3
10941,s20823276,20823276,은사실헤어샵,1,1,1,3
10942,s32092143,32092143,유미용실,1,1,1,3
10943,s18848744,18848744,수현미용실,1,1,1,3
10944,s1700690139,1700690139,정임수헤어팜,1,1,1,3
10945,s20869953,20869953,희미용실,1,1,1,3
10946,s1953942724,1953942724,윤희헤어컷,1,1,1,3
10947,s1329205423,1329205423,궁전미용실,1,1,1,3
10948,s20843051,20843051,김보연헤어샵,1,1,1,3
10949,s1304015386,1304015386,선희헤어샵,1,1,1,3
10950,s20927034,20927034,장미헤어아트,1,1,1,3
10951,s20839090,20839090,이수란헤어뉴스,1,1,1,3
10952,s18864607,18864607,은혜미용실,1,1,1,3
10953,s1079522612,1079522612,헤어라운지,1,1,1,3
10954,s20858485,20858485,명동미용실,1,1,1,3
10955,s1714161547,1714161547,박연순미용실,1,1,1,3
10956,s31694513,31694513,이든헤어,1,1,1,3
10957,s21705627,21705627,e붙임머리 동대문점,1,1,1,3
10958,s20850794,20850794,머리머리,1,1,1,3
10959,s34585412,34585412,유니크,1,1,1,3
10960,s37475051,37475051,헤어스토리,1,1,1,3
10961,s1312199556,1312199556,오늘hair,1,1,1,3
10962,s38481862,38481862,미첼헤어폼,1,1,1,3
10963,s1272881074,1272881074,마리헤어,1,1,1,3
10964,s19810569,19810569,Hair van,1,1,1,3
10965,s38759668,38759668,헬로펌 장안점,1,1,1,3
10966,s1150126152,1150126152,아이엠 헤어살롱,1,1,1,3
10967,s1808584315,1808584315,빨강머리앤,1,1,1,3
10968,s1143716233,1143716233,썬헤어,1,1,1,3
10969,s1320965720,1320965720,큐사랑,1,1,1,3
10970,sk142242411,k142242411,온헤어,1,1,1,3
10971,s20923566,20923566,장안미용실,1,1,1,3
10972,s20916853,20916853,헤어온,1,1,1,3
10973,s20862339,20862339,이창숙헤어샵,1,1,1,3
10974,s20942342,20942342,최신헤어클럽,1,1,1,3
10975,s1329566815,1329566815,후헤어,1,1,1,3
10976,s1066442320,1066442320,헤어뱅크,1,1,1,3
10977,s38673053,38673053,지나데일리헤어,1,1,1,3
10978,s20942450,20942450,정미용실,1,1,1,3
10979,s1959886050,1959886050,HD헤어,1,1,1,3
10980,s1736713705,1736713705,티아라헤어,1,1,1,3
10981,s20908144,20908144,김소연헤어,1,1,1,3
10982,s1041056470,1041056470,디아트,1,1,1,3
10983,s19854933,19854933,김윤정헤어내담,1,1,1,3
10984,s20904414,20904414,원헤어클럽,1,1,1,3
10985,s1821731955,1821731955,J헤어136,1,1,1,3
10986,s18052209,18052209,정명희미용실,1,1,1,3
10987,s35379395,35379395,헤어카페루미에르,1,1,1,3
10988,s1433606439,1433606439,현헤어센스,1,1,1,3
10989,s1757938288,1757938288,예쁜헤어,1,1,1,3
10990,s1844233104,1844233104,헤어갤러리,1,1,1,3
10991,s1786768964,1786768964,루디아헤어,1,1,1,3
10992,s1512681976,1512681976,미앤헤어,1,1,1,3
10993,s18052573,18052573,한승미미용실,1,1,1,3
10994,s18850889,18850889,혜은헤어,1,1,1,3
10995,s18855217,18855217,미소미용실,1,1,1,3
10996,s18849609,18849609,로레알미용실,1,1,1,3
10997,s1697625305,1697625305,모드니헤어,1,1,1,3
10998,s1066215398,1066215398,윤헤어,1,1,1,3
10999,s20938613,20938613,윤미용실,1,1,1,3
11000,s1366460822,1366460822,윤헤어코디,1,1,1,3
11001,s1693050671,1693050671,헤어살롱B&G,1,1,1,3
11002,s20923552,20923552,현헤어아트,1,1,1,3
11003,s20827435,20827435,파랑새미용실,1,1,1,3
11004,s32090890,32090890,선헤어뉴스,1,1,1,3
11005,s18849723,18849723,뷰티헤어샵,1,1,1,3
11006,s13284242,13284242,미전문헤어살롱,1,1,1,3
11007,s1215631188,1215631188,리프로미용실,1,1,1,3
11008,s18858806,18858806,현미용실,1,1,1,3
11009,s1267687065,1267687065,서연헤어커커,1,1,1,3
11010,s1927237557,1927237557,코코헤어스케치,1,1,1,3
11011,s530999032,530999032,EK Hair,1,1,1,3
11012,s20854621,20854621,새내기투,1,1,1,3
11013,s20858463,20858463,샴푸미용실,1,1,1,3
11014,s20892867,20892867,강경자궁전미용실,1,1,1,3
11015,s20510841,20510841,김헤어샵,1,1,1,3
11016,s1087246600,1087246600,헤어플러스미,1,1,1,3
11017,s20858290,20858290,쉐리헤어필,1,1,1,3
11018,s36870523,36870523,J 민헤어,1,1,1,3
11019,s1302429460,1302429460,머리사랑,1,1,1,3
11020,s20938735,20938735,머리여행,1,1,1,3
11021,s20835245,20835245,주니헤어스토리,1,1,1,3
11022,s20835291,20835291,백조헤어샵,1,1,1,3
11023,s1093787809,1093787809,화이트 미용실,1,1,1,3
11024,s18857567,18857567,정은헤어,1,1,1,3
11025,s1514422521,1514422521,앙상블헤어,1,1,1,3
11026,s1185112574,1185112574,헤어작업실,1,1,1,3
11027,s20908303,20908303,B&B헤어 장안점,1,1,1,3
11028,s18861588,18861588,프로미용실,1,1,1,3
11029,s20873890,20873890,정현헤어가이,1,1,1,3
11030,s20850785,20850785,헤어코리아,1,1,1,3
11031,s1502162662,1502162662,스링헤어,1,1,1,3
11032,s20915717,20915717,정미용실,1,1,1,3
11033,s586560119,586560119,BoBo Hair,1,1,1,3
11034,s1010494687,1010494687,미광헤어,1,1,1,3
11035,sk1082496102,k1082496102,헤어바이준쓰,1,1,1,3
11036,s1103910134,1103910134,쟈르댕뷰티헤어,1,1,1,3
11037,s1296912584,1296912584,by진,1,1,1,3
11038,s1301976507,1301976507,힐링헤어샵,1,1,1,3
11039,s30849734,30849734,헤어코디,1,1,1,3
11040,s20835165,20835165,수지헤어,1,1,1,3
11041,s36912944,36912944,데이지헤어,1,1,1,3
11042,s20893131,20893131,미라클,1,1,1,3
11043,s1074943112,1074943112,은하헤어,1,1,1,3
11044,s1014148497,1014148497,머리향기,1,1,1,3
11045,s1647327141,1647327141,란헤어,1,1,1,3
11046,s1728343085,1728343085,작은거인헤어,1,1,1,3
11047,s1085582019,1085582019,머리사랑,1,1,1,3
11048,s18864565,18864565,우현헤어라인,1,1,1,3
11049,s1510965635,1510965635,하슬라헤어샵,1,1,1,3
11050,s280644401,280644401,VA헤어메이크업두피,1,1,1,3
11051,s1044939465,1044939465,샤론헤어샾,1,1,1,3
11052,s20919679,20919679,선헤어샵,1,1,1,3
11053,s1672492613,1672492613,유정미용실,1,1,1,3
11054,s18054097,18054097,최가을헤어드레서 전농점,1,1,1,3
11055,s20881571,20881571,난다랑미용실,1,1,1,3
11056,s21646187,21646187,벨리타헤어,1,1,1,3
11057,s18107781,18107781,우성,1,1,1,3
11058,s36462456,36462456,헤어톡톡,1,1,1,3
11059,s20866069,20866069,태평미용실,1,1,1,3
11060,s19581032,19581032,이즈헤어,1,1,1,3
11061,s61382836,61382836,햇빛헤어샵,1,1,1,3
11062,s1481499513,1481499513,이라염색방,1,1,1,3
11063,s1756687597,1756687597,진주미용실,1,1,1,3
11064,s1056315705,1056315705,바람난여우,1,1,1,3
11065,s20873872,20873872,김정은미용실,1,1,1,3
11066,s18084266,18084266,진화영헤어샵,1,1,1,3
11067,s20931136,20931136,아씨헤어,1,1,1,3
11068,sk18045463,k18045463,엔미용실,1,1,1,3
11069,s1443055482,1443055482,The끌림,1,1,1,3
11070,s1181603491,1181603491,와이앤제이헤어,1,1,1,3
11071,s20854551,20854551,신데렐라헤어샵,1,1,1,3
11072,s20838933,20838933,하은헤어,1,1,1,3
11073,s18045467,18045467,헤어클릭,1,1,1,3
11074,s20886415,20886415,헤어아이디,1,1,1,3
11075,s1237701325,1237701325,살롱드헤어 젠,1,1,1,3
11076,s18086956,18086956,압구정헤어,1,1,1,3
11077,s13179689,13179689,전혜리뷰티샾,1,1,1,3
11078,s20892855,20892855,헤어리더,1,1,1,3
11079,s20505965,20505965,헤어홀릭,1,1,1,3
11080,s18084253,18084253,베누스미용실,1,1,1,3
11081,s1250474770,1250474770,가위손헤어샵,1,1,1,3
11082,s18863989,18863989,주연미용실,1,1,1,3
11083,s19978249,19978249,귀향미용실,1,1,1,3
11084,s20827465,20827465,서울미용실,1,1,1,3
11085,s34713835,34713835,헤어스튜디오,1,1,1,3
11086,s1343902792,1343902792,내가 찾던 미용실,1,1,1,3
11087,s18859816,18859816,제니스헤어,1,1,1,3
11088,s1615592482,1615592482,히노키헤어,1,1,1,3
11089,s1556686019,1556686019,현준헤어,1,1,1,3
11090,s20942372,20942372,헤어이슈,1,1,1,3
11091,s20904514,20904514,강희미용실,1,1,1,3
11092,s18847223,18847223,노랑머리,1,1,1,3
11093,s20922605,20922605,주명자헤어ID,1,1,1,3
11094,s20835238,20835238,펄헤어두,1,1,1,3
11095,s1289469728,1289469728,리안헤어장안동점,1,1,1,3
11096,s1135245904,1135245904,머리카락헤어샵,1,1,1,3
11097,s11729891,11729891,블루클럽 제기점,1,1,1,3
11098,s1052601402,1052601402,샤뜨헤어,1,1,1,3
11099,s20885354,20885354,이다헤어,1,1,1,3
11100,s1151438865,1151438865,왈바버샵,1,1,1,3
11101,s20927283,20927283,나정헤어샵,1,1,1,3
11102,s20938693,20938693,진주헤어샵,1,1,1,3
11103,s20836233,20836233,헤어살롱,1,1,1,3
11104,s18041032,18041032,최가네가위손,1,1,1,3
11105,s1948555940,1948555940,여우나라,1,1,1,3
11106,s1975521728,1975521728,고헤어클럽,1,1,1,3
11107,s20846905,20846905,현대헤어,1,1,1,3
11108,s1341241198,1341241198,꽃집미용실,1,1,1,3
11109,s18045476,18045476,센스미용,1,1,1,3
11110,s1019518045,1019518045,춤추는머리나라,1,1,1,3
11111,s21818077,21818077,황s헤어,1,1,1,3
11112,s20885433,20885433,헤어랜드,1,1,1,3
11113,s20923437,20923437,영미용실,1,1,1,3
11114,s18045490,18045490,멋뜰미용실,1,1,1,3
11115,s1016241025,1016241025,멋뜰뷰티헤어,1,1,1,3
11116,s20877603,20877603,헤어모델,1,1,1,3
11117,s20846864,20846864,연정미용실,1,1,1,3
11118,s20927195,20927195,조은미장,1,1,1,3
11119,s18052221,18052221,보희미용실,1,1,1,3
11120,s20900528,20900528,진미용실,1,1,1,3
11121,s1334153901,1334153901,가세미용실,1,1,1,3
11122,s1817283025,1817283025,수헤어샾,1,1,1,3
11123,s1039039135,1039039135,경아헤어샵,1,1,1,3
11124,s20877626,20877626,뽀끌레미용실,1,1,1,3
11125,s18035061,18035061,방울미용실,1,1,1,3
11126,s11729901,11729901,블루클럽 회기역점,1,1,1,3
11127,s1500399781,1500399781,고마운헤어,1,1,1,3
11128,s1558306446,1558306446,WE헤어,1,1,1,3
11129,s18865070,18865070,비아헤어,1,1,1,3
11130,s20869945,20869945,라보떼헤어,1,1,1,3
11131,s37793679,37793679,바이민헤어,1,1,1,3
11132,s35424857,35424857,헤어존,1,1,1,3
11133,s1735592178,1735592178,유승헤어,1,1,1,3
11134,s20862135,20862135,메두사,1,1,1,3
11135,s1006557429,1006557429,미스홍헤어샵,1,1,1,3
11136,s1763716879,1763716879,자연결미용실,1,1,1,3
11137,s20939643,20939643,미앤미헤어,1,1,1,3
11138,s38272213,38272213,미수싸롱,1,1,1,3
11139,s20858263,20858263,선영헤어,1,1,1,3
11140,s20927313,20927313,임경애헤어클럽,1,1,1,3
11141,s20889266,20889266,하주옥미용타운,1,1,1,3
11142,s37553899,37553899,헤어마벨,1,1,1,3
11143,s11890330,11890330,가쯔헤어,1,1,1,3
11144,s1992437124,1992437124,가위소리,1,1,1,3
11145,s20858311,20858311,유현주헤어,1,1,1,3
11146,s1640418735,1640418735,헤어컬러 레드,1,1,1,3
11147,s1050783280,1050783280,헤어브리오,1,1,1,3
11148,s1119181907,1119181907,에드워드 가위손 미용실,1,1,1,3
11149,s1522823390,1522823390,샤인즈헤어,1,1,1,3
11150,s1330618048,1330618048,미림헤어,1,1,1,3
11151,s20858428,20858428,루디아헤어,1,1,1,3
11152,s18070109,18070109,다사랑미용실,1,1,1,3
11153,s20900485,20900485,까미헤어,1,1,1,3
11154,s34714221,34714221,TOP헤어갤러리 경희대점,1,1,1,3
11155,s18035067,18035067,엔젤헤어,1,1,1,3
11156,s18848507,18848507,뉴헤어센스,1,1,1,3
11157,s1174269790,1174269790,뉴헤어센스,1,1,1,3
11158,s19567402,19567402,알렌느헤어,1,1,1,3
11159,s965377380,965377380,마르셀헤어,1,1,1,3
11160,s1543042579,1543042579,쭈야살롱,1,1,1,3
11161,s20915886,20915886,지오헤어,1,1,1,3
11162,s38510517,38510517,VIPAGAIN,1,1,1,3
11163,s1789997917,1789997917,웰라미용실,1,1,1,3
11164,s1800872301,1800872301,미발미용실,1,1,1,3
11165,s18059195,18059195,최종숙머리방,1,1,1,3
11166,s1883640833,1883640833,센스헤어,1,1,1,3
11167,s1668500114,1668500114,문미용실,1,1,1,3
11168,s20854447,20854447,송미용실,1,1,1,3
11169,s1544854993,1544854993,수컷,1,1,1,3
11170,s20839108,20839108,장미헤어아트,1,1,1,3
11171,s11729887,11729887,블루클럽 전농로터리점,1,1,1,3
11172,s20827291,20827291,유민헤어콜렉션휘경점,1,1,1,3
11173,s870890469,870890469,퓨마헤어,1,1,1,3
11174,s20870121,20870121,피카소헤어클럽,1,1,1,3
11175,s1440348673,1440348673,태후사랑 장안점,1,1,1,3
11176,s1077224046,1077224046,금헤어,1,1,1,3
11177,s18852744,18852744,송미용실,1,1,1,3
11178,s1966837058,1966837058,다사랑미용실,1,1,1,3
11179,s1615266397,1615266397,헤어코스,1,1,1,3
11180,s1264800767,1264800767,J&Y헤어아트,1,1,1,3
11181,s1511240707,1511240707,김희정헤어,1,1,1,3
11182,s1192101020,1192101020,맨투맨,1,1,1,3
11183,s20893110,20893110,오브제헤어,1,1,1,3
11184,s20927224,20927224,미체,1,1,1,3
11185,s1683159486,1683159486,헤어센스,1,1,1,3
11186,s684740231,684740231,김세희헤어,1,1,1,3
11187,s21413307,21413307,참아름다움 헤어살롱,1,1,1,3
11188,s20841955,20841955,헤어아트,1,1,1,3
11189,s1162362056,1162362056,제이헤어샵,1,1,1,3
11190,s1130225680,1130225680,이유정헤어살롱,1,1,1,3
11191,s809568483,809568483,체인지 유 헤어살롱,1,1,1,3
11192,s1575094283,1575094283,스펠라헤어,1,1,1,3
11193,s1746282474,1746282474,5살롱,1,1,1,3
11194,s37257544,37257544,두리헤어샵,1,1,1,3
11195,s1444814270,1444814270,투텐맨즈헤어,1,1,1,3
11196,s31398033,31398033,헤어스타,1,1,1,3
11197,s1510974053,1510974053,헤어끼,1,1,1,3
11198,s18771324,18771324,비포앤애프터,1,1,1,3
11199,s11550550,11550550,유연수헤어샾,1,1,1,3
11200,s19026260,19026260,지윤헤어아트,1,1,1,3
11201,s1950149246,1950149246,탑헤어 마포점,1,1,1,3
11202,s1077282624,1077282624,머리사랑,1,1,1,3
11203,s1288524319,1288524319,토마토헤어,1,1,1,3
11204,s1559106195,1559106195,엣지,1,1,1,3
11205,s350317321,350317321,헤어모니,1,1,1,3
11206,s20844757,20844757,오늘머리하는집미용실,1,1,1,3
11207,s635115429,635115429,윤헤어,1,1,1,3
11208,s254784947,254784947,JK미용실,1,1,1,3
11209,s36652065,36652065,LUCY&J헤어살롱,1,1,1,3
11210,s1746012806,1746012806,빗과가위사이,1,1,1,3
11211,s178329911,178329911,스타일리스트헤어,1,1,1,3
11212,s521087644,521087644,다온헤어,1,1,1,3
11213,s35125407,35125407,르메이헤어,1,1,1,3
11214,s1789715696,1789715696,망원헤어살롱,1,1,1,3
11215,s326357593,326357593,손헤어갤러리 망원점,1,1,1,3
11216,s1920941156,1920941156,지니미용실,1,1,1,3
11217,s1583024373,1583024373,윤희 헤어,1,1,1,3
11218,s18797676,18797676,미시헤어샵,1,1,1,3
11219,s18795418,18795418,안성미용실,1,1,1,3
11220,s1224938340,1224938340,샤론미용실,1,1,1,3
11221,s18352268,18352268,큐앤큐,1,1,1,3
11222,s1284248194,1284248194,장지연헤어,1,1,1,3
11223,s18793800,18793800,연세미용타운,1,1,1,3
11224,s1810695762,1810695762,이헤어,1,1,1,3
11225,s18387605,18387605,은경미용실,1,1,1,3
11226,s1880592718,1880592718,블로비헤어 망원점,1,1,1,3
11227,s36324269,36324269,MY헤어살롱,1,1,1,3
11228,s20825081,20825081,빠리미용실,1,1,1,3
11229,s18793834,18793834,진미용실,1,1,1,3
11230,s32058088,32058088,빨간머리앤미용실,1,1,1,3
11231,s1908762392,1908762392,김희정미용실,1,1,1,3
11232,s726800928,726800928,미스터 헤어,1,1,1,3
11233,s1817292233,1817292233,숲속남성컷,1,1,1,3
11234,s109446791,109446791,BOO HAIR,1,1,1,3
11235,s1363791321,1363791321,럭스헤어,1,1,1,3
11236,s1220092965,1220092965,가빈헤어,1,1,1,3
11237,s1174634241,1174634241,헤어헤어,1,1,1,3
11238,s1566133110,1566133110,시즌헤어,1,1,1,3
11239,s1384548040,1384548040,주은헤어,1,1,1,3
11240,s33636262,33636262,저스트헤어,1,1,1,3
11241,s1603626853,1603626853,퀸즈헤어,1,1,1,3
11242,s18360046,18360046,헤어오클리,1,1,1,3
11243,s1052836382,1052836382,김혜자미용실,1,1,1,3
11244,sk1488337785,k1488337785,아이디뷰티,1,1,1,3
11245,s32053135,32053135,린다,1,1,1,3
11246,s31397599,31397599,서희헤어샵,1,1,1,3
11247,s1330671335,1330671335,에스필로,1,1,1,3
11248,s1905437902,1905437902,준서헤어,1,1,1,3
11249,s38474944,38474944,Finhair,1,1,1,3
11250,s20902331,20902331,헤어소리,1,1,1,3
11251,s1359148122,1359148122,이음머리공작소 홍대점,1,1,1,3
11252,s37793980,37793980,앤붙임머리,1,1,1,3
11253,s1908947844,1908947844,위드 A 헤어,1,1,1,3
11254,s1301584087,1301584087,수수한 헤어살롱,1,1,1,3
11255,s1049913713,1049913713,H Room,1,1,1,3
11256,s1542043814,1542043814,도도헤어,1,1,1,3
11257,s1086738206,1086738206,헤어바비시대,1,1,1,3
11258,s945710564,945710564,마스터 핸드,1,1,1,3
11259,s1665018757,1665018757,제이헤어,1,1,1,3
11260,s1857133652,1857133652,헤어유유,1,1,1,3
11261,s20836790,20836790,무리헤어샵,1,1,1,3
11262,s169729576,169729576,415hairshop,1,1,1,3
11263,s1368693895,1368693895,예사붙임머리 홍대본점,1,1,1,3
11264,s1159893890,1159893890,프롬에이 하이쌤,1,1,1,3
11265,s1692033823,1692033823,제나헤어,1,1,1,3
11266,s1415587053,1415587053,헤일로 헤어샵,1,1,1,3
11267,s1921357203,1921357203,헤어바이엘,1,1,1,3
11268,s1853937565,1853937565,Li스타일,1,1,1,3
11269,s13155191,13155191,루나헤어,1,1,1,3
11270,s21428518,21428518,오라헤어살롱,1,1,1,3
11271,s1824275799,1824275799,브러쉬,1,1,1,3
11272,s1496973875,1496973875,허니러플,1,1,1,3
11273,s18800822,18800822,임애수헤어라인,1,1,1,3
11274,s1060467182,1060467182,터치바이미소,1,1,1,3
11275,s1855028990,1855028990,앤헤어,1,1,1,3
11276,s1404313456,1404313456,컷앤펌미용실,1,1,1,3
11277,s18386880,18386880,헤어필,1,1,1,3
11278,s1496871259,1496871259,J헤어,1,1,1,3
11279,s18386878,18386878,개미미용실,1,1,1,3
11280,s1477424006,1477424006,써니헤어,1,1,1,3
11281,s1738488046,1738488046,머리연출,1,1,1,3
11282,s37538068,37538068,시월애미모,1,1,1,3
11283,s37288635,37288635,H헤어,1,1,1,3
11284,s37383492,37383492,sunny헤어,1,1,1,3
11285,s37297846,37297846,머리전문가진원,1,1,1,3
11286,s37350238,37350238,비긴헤어,1,1,1,3
11287,s37327072,37327072,MIL,1,1,1,3
11288,s37350298,37350298,칵스콤헤어살롱,1,1,1,3
11289,s1735759642,1735759642,나이스가이 아현뉴타운점,1,1,1,3
11290,s37879970,37879970,헤어스토리,1,1,1,3
11291,s37690705,37690705,812 x mangwon,1,1,1,3
11292,s1379145432,1379145432,플로라헤어,1,1,1,3
11293,s1931786062,1931786062,가인헤어샵,1,1,1,3
11294,s92143006,92143006,마녀살롱,1,1,1,3
11295,s37864732,37864732,라피스헤어,1,1,1,3
11296,s1460937536,1460937536,현미용실,1,1,1,3
11297,s18801945,18801945,현미용실,1,1,1,3
11298,s20856294,20856294,두리헤어샵,1,1,1,3
11299,s1736714019,1736714019,지지미용실,1,1,1,3
11300,s1688794422,1688794422,준미용실,1,1,1,3
11301,s1606133671,1606133671,스타일J헤어,1,1,1,3
11302,s37197915,37197915,연남부띠끄,1,1,1,3
11303,s1997625426,1997625426,태후사랑 염리점,1,1,1,3
11304,s1574814258,1574814258,이우헤어,1,1,1,3
11305,s36893683,36893683,제니앤에스,1,1,1,3
11306,s1844998564,1844998564,헤어파크,1,1,1,3
11307,s11729959,11729959,블루클럽 아현시장점,1,1,1,3
11308,s1325025207,1325025207,스타헤어,1,1,1,3
11309,s48869064,48869064,원 헤어필름,1,1,1,3
11310,s1636720132,1636720132,김지희미용실,1,1,1,3
11311,s1162850512,1162850512,헤어시티,1,1,1,3
11312,s1768305378,1768305378,옥천이발관,1,1,1,3
11313,s1854860178,1854860178,토마토헤어샵,1,1,1,3
11314,s1942126087,1942126087,아현미용실,1,1,1,3
11315,s1948247748,1948247748,수도미용실,1,1,1,3
11316,s20929059,20929059,헤마코,1,1,1,3
11317,s1744843173,1744843173,브니엘 헤어라인,1,1,1,3
11318,s1527621333,1527621333,JN헤어,1,1,1,3
11319,s1341320650,1341320650,장미용실,1,1,1,3
11320,s33460735,33460735,예쁜머리하는미용실,1,1,1,3
11321,s20878960,20878960,지니헤어,1,1,1,3
11322,s18736859,18736859,준헤어샵,1,1,1,3
11323,s1875251093,1875251093,도도미용실,1,1,1,3
11324,s1664939699,1664939699,헤어샵헤라,1,1,1,3
11325,s20383592,20383592,가인헤어,1,1,1,3
11326,s18229365,18229365,가인헤어2호점,1,1,1,3
11327,s1684628915,1684628915,파스칼헤어살롱,1,1,1,3
11328,s32049721,32049721,김연우헤어샵,1,1,1,3
11329,s18743794,18743794,김가영헤어,1,1,1,3
11330,s1057889451,1057889451,재연미용실,1,1,1,3
11331,s36028641,36028641,친절한지니선생님,1,1,1,3
11332,s1614956801,1614956801,미앤느헤어,1,1,1,3
11333,s1465552728,1465552728,헤어빈,1,1,1,3
11334,s37065525,37065525,코난헤어,1,1,1,3
11335,s1208312814,1208312814,프렌즈 헤어,1,1,1,3
11336,s1561717435,1561717435,이지헤어,1,1,1,3
11337,s652234993,652234993,운학살롱,1,1,1,3
11338,s38533167,38533167,커팅포인트,1,1,1,3
11339,s1138726041,1138726041,홍수영헤어,1,1,1,3
11340,s35949394,35949394,풀잎헤어살롱,1,1,1,3
11341,s1235342495,1235342495,설렘헤어,1,1,1,3
11342,s1516845796,1516845796,헤어426,1,1,1,3
11343,s33305784,33305784,구피샵 망원점,1,1,1,3
11344,s1212803211,1212803211,모꼬지방,1,1,1,3
11345,s1621812281,1621812281,헤어아카데미,1,1,1,3
11346,s35555039,35555039,마이헤어,1,1,1,3
11347,s35735006,35735006,홍헤어,1,1,1,3
11348,s18772815,18772815,나무두에헤어모드,1,1,1,3
11349,s1900205240,1900205240,성은미용실,1,1,1,3
11350,s1236661628,1236661628,와이헤어라운지,1,1,1,3
11351,s18772538,18772538,가고파미용실,1,1,1,3
11352,s36630933,36630933,여유로움헤어,1,1,1,3
11353,s1485450960,1485450960,하나헤어,1,1,1,3
11354,s13153083,13153083,비오헤어갤러리,1,1,1,3
11355,s13154914,13154914,헤어솔제,1,1,1,3
11356,s1201605117,1201605117,SS1 HAIR,1,1,1,3
11357,s32040202,32040202,하이디뉴욕,1,1,1,3
11358,s20928393,20928393,아미헤어,1,1,1,3
11359,s11696702,11696702,쎄시카헤어,1,1,1,3
11360,s1519481764,1519481764,소나헤어,1,1,1,3
11361,s20677310,20677310,현지연헤어샵,1,1,1,3
11362,s36234333,36234333,김화영헤어샵,1,1,1,3
11363,s11570461,11570461,모세 미용실,1,1,1,3
11364,s35316724,35316724,유림헤어모드,1,1,1,3
11365,s20875541,20875541,봄헤어이대점,1,1,1,3
11366,s1634770570,1634770570,쉭시브미용그룹 이대점,1,1,1,3
11367,s31394223,31394223,로뎀헤어,1,1,1,3
11368,s1071794878,1071794878,부산미용실,1,1,1,3
11369,s1397900716,1397900716,가위손헤어샾,1,1,1,3
11370,s18773022,18773022,행복미용실,1,1,1,3
11371,s1699544756,1699544756,린 헤어샵,1,1,1,3
11372,s1404539561,1404539561,이은숙헤어,1,1,1,3
11373,s1394453664,1394453664,오늘도공간헤어,1,1,1,3
11374,s18754229,18754229,우정미용실,1,1,1,3
11375,s34349974,34349974,사계절헤어,1,1,1,3
11376,s1935225284,1935225284,사라헤어,1,1,1,3
11377,s1784362920,1784362920,오렌지헤어,1,1,1,3
11378,s1142224530,1142224530,HYANG 헤어,1,1,1,3
11379,s1800451630,1800451630,준헤어,1,1,1,3
11380,s13159277,13159277,웰라미용실,1,1,1,3
11381,s20867384,20867384,수빈헤어아트,1,1,1,3
11382,s18736948,18736948,미셀헤어클릭,1,1,1,3
11383,s1675756393,1675756393,빛나헤어,1,1,1,3
11384,s20939876,20939876,예쁜머리만들기,1,1,1,3
11385,s31393418,31393418,최정현프로페셔널,1,1,1,3
11386,s18738721,18738721,영광헤어프라자,1,1,1,3
11387,s18737872,18737872,헤어닷컴,1,1,1,3
11388,s31398004,31398004,엔젤헤어뱅크,1,1,1,3
11389,s20886662,20886662,즐거운미용실,1,1,1,3
11390,s18738649,18738649,헤어사랑,1,1,1,3
11391,s18738724,18738724,마헤어샵,1,1,1,3
11392,s1730815580,1730815580,김가혜헤어,1,1,1,3
11393,s20848134,20848134,꾸띠헤어,1,1,1,3
11394,s1303579437,1303579437,새마을헤어비전,1,1,1,3
11395,s20939815,20939815,수빈헤어아트,1,1,1,3
11396,s18267924,18267924,선머리방,1,1,1,3
11397,s1113848904,1113848904,나드리미용실,1,1,1,3
11398,s36666954,36666954,디앤이헤어,1,1,1,3
11399,s20867912,20867912,은인초헤어,1,1,1,3
11400,s1521674113,1521674113,노블레스헤어,1,1,1,3
11401,s1451923444,1451923444,수미용실,1,1,1,3
11402,s20940335,20940335,이지선미용실,1,1,1,3
11403,s13150740,13150740,김민헤어,1,1,1,3
11404,s20940306,20940306,명인미용실,1,1,1,3
11405,s1312447828,1312447828,박정은헤어크리닉,1,1,1,3
11406,s1682420047,1682420047,벨&보헤어,1,1,1,3
11407,s38555508,38555508,다우리 헤어 메이크업,1,1,1,3
11408,s489975885,489975885,은사실헤어,1,1,1,3
11409,s20924565,20924565,구민선헤어샵,1,1,1,3
11410,s1943058647,1943058647,영천헤어샵,1,1,1,3
11411,s18736412,18736412,뉴헤어센스,1,1,1,3
11412,s1699089845,1699089845,멋 헤어라인,1,1,1,3
11413,s1303620401,1303620401,영미용실,1,1,1,3
11414,s20921249,20921249,헤어히스토리,1,1,1,3
11415,s20939898,20939898,호산나미용실,1,1,1,3
11416,s20871143,20871143,동아미용실,1,1,1,3
11417,s37411060,37411060,살롱드봄,1,1,1,3
11418,s1445541531,1445541531,영 앤 미 헤어,1,1,1,3
11419,s1146779796,1146779796,고은헤어샵,1,1,1,3
11420,s1894944081,1894944081,참멋헤어,1,1,1,3
11421,s20874972,20874972,오리온미용실,1,1,1,3
11422,s20939743,20939743,정미용실,1,1,1,3
11423,s1104609193,1104609193,월드미용실,1,1,1,3
11424,s18213288,18213288,머리하기좋은날,1,1,1,3
11425,s20840217,20840217,이루다미용타운,1,1,1,3
11426,s32045418,32045418,여성시대헤어타운김은자,1,1,1,3
11427,s20886571,20886571,헤어모드,1,1,1,3
11428,s18758192,18758192,한서미용실,1,1,1,3
11429,s31395037,31395037,펌앤컷헤어샵,1,1,1,3
11430,s18749962,18749962,미다듬헤어휠,1,1,1,3
11431,s34348954,34348954,샤론헤어아트,1,1,1,3
11432,s1466605344,1466605344,윤미용실,1,1,1,3
11433,s38304903,38304903,연희미장원,1,1,1,3
11434,s1852935809,1852935809,바오,1,1,1,3
11435,s37327230,37327230,PEOPLE&PEOPLES,1,1,1,3
11436,s1691057909,1691057909,윤진헤어,1,1,1,3
11437,s31880315,31880315,홍현수헤어,1,1,1,3
11438,s1513122148,1513122148,엘헤어,1,1,1,3
11439,s1695282070,1695282070,제이앤와이헤어,1,1,1,3
11440,s18740437,18740437,헤어닥터,1,1,1,3
11441,s20882919,20882919,호수헤어샵,1,1,1,3
11442,s18741212,18741212,제이스타일,1,1,1,3
11443,s1116200285,1116200285,은미헤어체크,1,1,1,3
11444,s20935934,20935934,신헤어라인,1,1,1,3
11445,s18268084,18268084,헤어코디,1,1,1,3
11446,s1019521410,1019521410,이현수미용실,1,1,1,3
11447,s20874852,20874852,헤어뱅크,1,1,1,3
11448,s1859877662,1859877662,리치헤어,1,1,1,3
11449,s1627404582,1627404582,란헤어,1,1,1,3
11450,s18286138,18286138,은혜미용실,1,1,1,3
11451,s20736041,20736041,유미용실,1,1,1,3
11452,s18289187,18289187,박미용실,1,1,1,3
11453,s36005272,36005272,정문미용실,1,1,1,3
11454,s18288310,18288310,무지개미용실,1,1,1,3
11455,s20932240,20932240,선희헤어샵,1,1,1,3
11456,s18760379,18760379,머리자랑,1,1,1,3
11457,s20939742,20939742,헤어큐미용실,1,1,1,3
11458,s20894069,20894069,은하수헤어갤러리,1,1,1,3
11459,s18278297,18278297,해오름헤어뱅크,1,1,1,3
11460,s18228669,18228669,이현미헤어패턴,1,1,1,3
11461,s1904535309,1904535309,유정미용실,1,1,1,3
11462,s1326755512,1326755512,헤어필미용실,1,1,1,3
11463,s1329331332,1329331332,노블레스헤어,1,1,1,3
11464,s18232218,18232218,황은경더스타일,1,1,1,3
11465,s18778907,18778907,정연헤어,1,1,1,3
11466,s1666443522,1666443522,오땡큐 합정점,1,1,1,3
11467,s1567565668,1567565668,저기저헤어,1,1,1,3
11468,s1119256206,1119256206,진헤어,1,1,1,3
11469,s1663686559,1663686559,엘헤어,1,1,1,3
11470,s1751783593,1751783593,헤어뉴스,1,1,1,3
11471,s33109211,33109211,ROOM3,1,1,1,3
11472,s1579349644,1579349644,FallGreen Hairsalon,1,1,1,3
11473,s18801411,18801411,헤어매직,1,1,1,3
11474,s1597694450,1597694450,연남동 미장원,1,1,1,3
11475,s1488887656,1488887656,목화헤어,1,1,1,3
11476,s1456984280,1456984280,더 시즌 헤어,1,1,1,3
11477,s20875659,20875659,수헤어쇼,1,1,1,3
11478,s18775770,18775770,샬롬미용실,1,1,1,3
11479,s1836795618,1836795618,주 헤어,1,1,1,3
11480,s1302208321,1302208321,로이 앤 클로이,1,1,1,3
11481,s1905341803,1905341803,피넛헤어샵,1,1,1,3
11482,s1387686985,1387686985,루미에르 홍대점,1,1,1,3
11483,s1410334256,1410334256,메타,1,1,1,3
11484,s1386950832,1386950832,시크앤,1,1,1,3
11485,s1230923893,1230923893,디바헤어,1,1,1,3
11486,s1757271754,1757271754,유루유루헤어,1,1,1,3
11487,s702315997,702315997,헤어스토리오늘,1,1,1,3
11488,s1004450547,1004450547,유앤나헤어,1,1,1,3
11489,s1701015798,1701015798,보노헤어,1,1,1,3
11490,s1840473576,1840473576,아뜰리에 봄,1,1,1,3
11491,s1841554350,1841554350,상수헤어,1,1,1,3
11492,s1123976100,1123976100,핀칠리로드헤어샵,1,1,1,3
11493,s11590642,11590642,도로시,1,1,1,3
11494,s1639785296,1639785296,뷔븨,1,1,1,3
11495,s18779610,18779610,새론헤어라인,1,1,1,3
11496,s1467838996,1467838996,헤어더뷰,1,1,1,3
11497,s1597216719,1597216719,Aveda men,1,1,1,3
11498,s1617819311,1617819311,헤어프레스,1,1,1,3
11499,s1514770786,1514770786,살롱드넬,1,1,1,3
11500,s1270502019,1270502019,살롱드하슬,1,1,1,3
11501,s1126821129,1126821129,이강숙헤어,1,1,1,3
11502,s1566488331,1566488331,장헤어,1,1,1,3
11503,s1735968772,1735968772,소울헤어,1,1,1,3
11504,s18798198,18798198,주연헤어센스,1,1,1,3
11505,s1369611003,1369611003,염색하우스,1,1,1,3
11506,s1239208255,1239208255,유나헤어샵,1,1,1,3
11507,s207605744,207605744,감성,1,1,1,3
11508,s1106516363,1106516363,레베카헤어,1,1,1,3
11509,s1774954794,1774954794,달빛헤어,1,1,1,3
11510,s1908665416,1908665416,핸썸가이,1,1,1,3
11511,s32059579,32059579,남지현헤어디자인,1,1,1,3
11512,s32032149,32032149,귀티나,1,1,1,3
11513,s18248879,18248879,연희미용실,1,1,1,3
11514,s36438564,36438564,연hair,1,1,1,3
11515,s20920680,20920680,설희헤어,1,1,1,3
11516,s1007579333,1007579333,리헤어,1,1,1,3
11517,s1673808346,1673808346,하나미용실,1,1,1,3
11518,s1822471824,1822471824,연대미용실,1,1,1,3
11519,s20920678,20920678,머리예술,1,1,1,3
11520,s20828664,20828664,무궁화미용실,1,1,1,3
11521,s18758877,18758877,은주헤어뉴스,1,1,1,3
11522,s20824517,20824517,진아미용실,1,1,1,3
11523,s1707327321,1707327321,눈부신하루를,1,1,1,3
11524,s20932284,20932284,쎄일미용실,1,1,1,3
11525,s18287210,18287210,오은희머리방,1,1,1,3
11526,s13150726,13150726,우정미용실,1,1,1,3
11527,s18756096,18756096,최정아헤어뉴스,1,1,1,3
11528,s18208815,18208815,서일미용실,1,1,1,3
11529,s20871130,20871130,정미용실,1,1,1,3
11530,s1621703525,1621703525,규수미용실,1,1,1,3
11531,s20820693,20820693,아름헤어라인,1,1,1,3
11532,s20928435,20928435,선미용실,1,1,1,3
11533,s18751701,18751701,이지연뷰티헤어,1,1,1,3
11534,s1974551186,1974551186,준헤어,1,1,1,3
11535,s20848188,20848188,란헤어샵,1,1,1,3
11536,s1130574875,1130574875,더순헤어,1,1,1,3
11537,s1549446294,1549446294,노블헤어바디샵,1,1,1,3
11538,s18797881,18797881,샵2헤어뷰띠크,1,1,1,3
11539,s1213964785,1213964785,헤어매치,1,1,1,3
11540,s1371494069,1371494069,헤어뷰띠끄,1,1,1,3
11541,s18386207,18386207,우정미용실,1,1,1,3
11542,s1414113145,1414113145,살롱시선,1,1,1,3
11543,s1453720979,1453720979,배화미용실,1,1,1,3
11544,s20832571,20832571,김희정모즈헤어,1,1,1,3
11545,s18750759,18750759,디니미용실,1,1,1,3
11546,s36005269,36005269,윤헤어센스미용실,1,1,1,3
11547,s18284880,18284880,선녀미용실,1,1,1,3
11548,s18282528,18282528,수정미용실,1,1,1,3
11549,s1818990470,1818990470,원미용실,1,1,1,3
11550,s20897990,20897990,경미용실,1,1,1,3
11551,s20863423,20863423,영미용실,1,1,1,3
11552,s18284206,18284206,태양미용실,1,1,1,3
11553,s20909443,20909443,초원파마타운,1,1,1,3
11554,s18749198,18749198,늘봄미용실,1,1,1,3
11555,s36459628,36459628,엘리스헤어,1,1,1,3
11556,s1042959735,1042959735,메이헤어,1,1,1,3
11557,s451224616,451224616,조경미헤어샵,1,1,1,3
11558,s32407448,32407448,하스헤어,1,1,1,3
11559,s1843433049,1843433049,머리쟁이,1,1,1,3
11560,s33028541,33028541,JHair,1,1,1,3
11561,s19022889,19022889,제이헤어,1,1,1,3
11562,s660979619,660979619,우송원헤어,1,1,1,3
11563,s225906504,225906504,머리예쁨,1,1,1,3
11564,s480824760,480824760,유민헤어,1,1,1,3
11565,s539776765,539776765,장승배기로이헤어,1,1,1,3
11566,s1646177166,1646177166,DY헤어,1,1,1,3
11567,s446865669,446865669,도로시헤어,1,1,1,3
11568,s1153130477,1153130477,민헤어,1,1,1,3
11569,s33471372,33471372,헤어스토리,1,1,1,3
11570,s20876706,20876706,방소연머리하는날,1,1,1,3
11571,s37465786,37465786,헤어톡,1,1,1,3
11572,s1891805779,1891805779,안젤라헤어,1,1,1,3
11573,s34907894,34907894,살롱에스,1,1,1,3
11574,s21688867,21688867,위드스타일헤어,1,1,1,3
11575,s38425012,38425012,맨투맨,1,1,1,3
11576,s1277661175,1277661175,맨투맨,1,1,1,3
11577,s20857325,20857325,헤어공감,1,1,1,3
11578,s32581997,32581997,헤어쿠데타,1,1,1,3
11579,s37049272,37049272,데일리헤어,1,1,1,3
11580,s37559216,37559216,벨라헤어,1,1,1,3
11581,s926881262,926881262,온누리헤어,1,1,1,3
11582,s1005810990,1005810990,오렌지헤어,1,1,1,3
11583,s20849795,20849795,옥헤어칼라,1,1,1,3
11584,s810876007,810876007,라파헤어,1,1,1,3
11585,s35586047,35586047,이다헤어,1,1,1,3
11586,s21558925,21558925,헤어갤러리 노량진점,1,1,1,3
11587,s1059786414,1059786414,이연헤어,1,1,1,3
11588,s1432433755,1432433755,준 헤어,1,1,1,3
11589,s20849895,20849895,태후사랑 상도1호점,1,1,1,3
11590,s1111715197,1111715197,J헤어,1,1,1,3
11591,s1195284727,1195284727,개성시대,1,1,1,3
11592,s737333997,737333997,오렌지헤어,1,1,1,3
11593,s844331138,844331138,이스트헤어,1,1,1,3
11594,s911531331,911531331,이영주헤어사당점,1,1,1,3
11595,s20896019,20896019,환희미용실,1,1,1,3
11596,s1197867265,1197867265,레드켄헤어,1,1,1,3
11597,s1483550375,1483550375,상록수헤어샵,1,1,1,3
11598,s19021196,19021196,상록수헤어스튜디오,1,1,1,3
11599,s951746308,951746308,큐헤어,1,1,1,3
11600,s31729196,31729196,미헤어클럽,1,1,1,3
11601,s35554436,35554436,율헤어,1,1,1,3
11602,s36208752,36208752,에이원헤어,1,1,1,3
11603,s1352866372,1352866372,에코뷰티뷰리풀헤어,1,1,1,3
11604,s95658987,95658987,Hairlab 반포점,1,1,1,3
11605,s701346535,701346535,잇츠미헤어,1,1,1,3
11606,s122299568,122299568,메씨헤어,1,1,1,3
11607,s18765802,18765802,한혜준 헤어,1,1,1,3
11608,s463211775,463211775,사라헤어,1,1,1,3
11609,s151188521,151188521,비숍헤어,1,1,1,3
11610,s1248400841,1248400841,춘자네미용실,1,1,1,3
11611,s1679696125,1679696125,머리에반하다,1,1,1,3
11612,s331227796,331227796,마영랑헤어,1,1,1,3
11613,s41709709,41709709,정상헤어,1,1,1,3
11614,s663186242,663186242,택시헤어 신대방삼거리점,1,1,1,3
11615,s724236432,724236432,아예쁘다,1,1,1,3
11616,s1769847482,1769847482,나은헤어,1,1,1,3
11617,s1661800909,1661800909,헤어블러썸,1,1,1,3
11618,s1082367825,1082367825,ennismore hair,1,1,1,3
11619,s1478275790,1478275790,지오헤어살롱,1,1,1,3
11620,s1587365687,1587365687,정준헤어,1,1,1,3
11621,s1392810979,1392810979,라움헤어,1,1,1,3
11622,s1048110312,1048110312,지은샵,1,1,1,3
11623,s1332647437,1332647437,개미헤어샵,1,1,1,3
11624,s96817497,96817497,헤어샤샤,1,1,1,3
11625,s38547954,38547954,헤어엔유,1,1,1,3
11626,s1454457917,1454457917,에이원미용실,1,1,1,3
11627,s88087420,88087420,청춘,1,1,1,3
11628,s36912670,36912670,JC헤어,1,1,1,3
11629,s21848558,21848558,태후사랑 신대방점,1,1,1,3
11630,s36898653,36898653,리볼브헤어,1,1,1,3
11631,s36871060,36871060,헤어프롬제이,1,1,1,3
11632,s1382845656,1382845656,미미헤어샵,1,1,1,3
11633,s13150676,13150676,남성역미용실 지니샵,1,1,1,3
11634,s1758616143,1758616143,허브헤어,1,1,1,3
11635,s37486765,37486765,아우룸헤어,1,1,1,3
11636,s1133041403,1133041403,차영헤어,1,1,1,3
11637,s1000994707,1000994707,머리가헤어,1,1,1,3
11638,s37918442,37918442,머리가 보라매역점,1,1,1,3
11639,s916732452,916732452,소영헤어샵,1,1,1,3
11640,s18680711,18680711,보경헤어,1,1,1,3
11641,s20895921,20895921,벨라지오헤어살롱,1,1,1,3
11642,s894732208,894732208,헤어카페,1,1,1,3
11643,s1047217423,1047217423,봄날헤어,1,1,1,3
11644,s1059253249,1059253249,에스에비뉴,1,1,1,3
11645,s38431367,38431367,안나헤어,1,1,1,3
11646,s38337518,38337518,부부샵,1,1,1,3
11647,s19031843,19031843,오복미용실,1,1,1,3
11648,s12061778,12061778,머리쟁이미용실,1,1,1,3
11649,s1165480831,1165480831,진헤어룩,1,1,1,3
11650,s13156820,13156820,뉴그랜드헤어샵,1,1,1,3
11651,s20822212,20822212,예쁜머리,1,1,1,3
11652,s858392489,858392489,헤어플러스,1,1,1,3
11653,s20822323,20822323,김원식헤어리더,1,1,1,3
11654,s299739991,299739991,안나미용실,1,1,1,3
11655,s59040501,59040501,헤어수피아,1,1,1,3
11656,s853659004,853659004,컷트클럽,1,1,1,3
11657,s1884691229,1884691229,이진헤어 메가스터디점,1,1,1,3
11658,s20834286,20834286,거리의멋쟁이,1,1,1,3
11659,s1921564494,1921564494,머리못하는집 사당48호점,1,1,1,3
11660,s20888256,20888256,블루클럽 남성역점,1,1,1,3
11661,s1063202041,1063202041,라인헤어,1,1,1,3
11662,s12994826,12994826,프레쉬헤어,1,1,1,3
11663,s1547751662,1547751662,정지혜헤어,1,1,1,3
11664,s20838162,20838162,중앙헤어클리닉,1,1,1,3
11665,s20826459,20826459,더헤어사당점,1,1,1,3
11666,s37999723,37999723,아가다헤어,1,1,1,3
11667,s1810201301,1810201301,정헤어,1,1,1,3
11668,s757573365,757573365,민헤어,1,1,1,3
11669,s20899663,20899663,신준헤어 사당본점,1,1,1,3
11670,s11872033,11872033,이선옥헤어클리닉,1,1,1,3
11671,s20899805,20899805,김주연헤어,1,1,1,3
11672,s20930192,20930192,모란헤어샵,1,1,1,3
11673,s18708059,18708059,테라헤어샾,1,1,1,3
11674,s20930170,20930170,가위소리헤어샵,1,1,1,3
11675,s18706099,18706099,소현헤어,1,1,1,3
11676,s13156668,13156668,금단헤어,1,1,1,3
11677,s18723279,18723279,헤어365,1,1,1,3
11678,s18723744,18723744,윤스헤어샵,1,1,1,3
11679,s19462461,19462461,수헤어,1,1,1,3
11680,s991927870,991927870,칩꾸아프 이수점,1,1,1,3
11681,s11485981,11485981,머리못하는집 사당점,1,1,1,3
11682,s20845951,20845951,바이준,1,1,1,3
11683,s1801357595,1801357595,스페셜제이,1,1,1,3
11684,s18729856,18729856,스마일헤어샵,1,1,1,3
11685,s1436947848,1436947848,수지미용실,1,1,1,3
11686,s18723332,18723332,최윤경헤어매직,1,1,1,3
11687,s18583347,18583347,하트원미용실,1,1,1,3
11688,s1262388068,1262388068,미용고수클럽,1,1,1,3
11689,s1158020967,1158020967,이수헤어,1,1,1,3
11690,s20853590,20853590,이영주헤어,1,1,1,3
11691,s1572479936,1572479936,이수in헤어,1,1,1,3
11692,s1291751151,1291751151,김미숙헤어컬렉션,1,1,1,3
11693,s1639864904,1639864904,귀빈미용실,1,1,1,3
11694,s1510916356,1510916356,윤헤어비젼,1,1,1,3
11695,s19017893,19017893,진선미미용실,1,1,1,3
11696,s433262954,433262954,로즈헤어샾,1,1,1,3
11697,s19867483,19867483,커트매니아,1,1,1,3
11698,s1119873959,1119873959,윤미용실,1,1,1,3
11699,s1332319706,1332319706,미가본미용실,1,1,1,3
11700,s20872797,20872797,신데렐라헤어샵,1,1,1,3
11701,s20799786,20799786,헤어트렌드,1,1,1,3
11702,s35572375,35572375,제오헤어 대림삼거리점,1,1,1,3
11703,s38557652,38557652,이훈 ALL 30000,1,1,1,3
11704,s1980732787,1980732787,이훈헤어칼라 신대방점,1,1,1,3
11705,s430258198,430258198,해헤어,1,1,1,3
11706,s251791150,251791150,미엔미헤어,1,1,1,3
11707,s1902054923,1902054923,럭스헤어,1,1,1,3
11708,s1200202422,1200202422,머리채미용실,1,1,1,3
11709,s1485034672,1485034672,윤헤어샵,1,1,1,3
11710,s675325474,675325474,문영헤어샵,1,1,1,3
11711,s1326221744,1326221744,다윈헤어,1,1,1,3
11712,s20890300,20890300,세라헤어라인,1,1,1,3
11713,s1116479051,1116479051,나리미용실,1,1,1,3
11714,s808577449,808577449,햅번스타일,1,1,1,3
11715,s18681921,18681921,세븐미용실,1,1,1,3
11716,s20911179,20911179,지니헤어라인,1,1,1,3
11717,s458045367,458045367,컷트클럽,1,1,1,3
11718,s18727409,18727409,나쁜여자미용실,1,1,1,3
11719,s1888153033,1888153033,행복한머리,1,1,1,3
11720,s1009914970,1009914970,프로헤어,1,1,1,3
11721,s20934059,20934059,민주헤어아트,1,1,1,3
11722,s1783024659,1783024659,풀헤어스,1,1,1,3
11723,s167336420,167336420,모노헤어,1,1,1,3
11724,s1773263135,1773263135,기능&헤어,1,1,1,3
11725,s20907456,20907456,현헤어,1,1,1,3
11726,s479720834,479720834,헤어갤러리신대방점,1,1,1,3
11727,s20884688,20884688,화이트헤어샵,1,1,1,3
11728,s38633618,38633618,제이헤어,1,1,1,3
11729,s20838009,20838009,머리사랑,1,1,1,3
11730,s20865230,20865230,에스쁘아헤어샵,1,1,1,3
11731,s38486731,38486731,앙포레모리노헤어 신대방점,1,1,1,3
11732,s38014883,38014883,앙포레모리노헤드스파,1,1,1,3
11733,s13156965,13156965,Soo헤어&헤드스파,1,1,1,3
11734,s888537621,888537621,까끌래뽀끌래,1,1,1,3
11735,s20926252,20926252,은혜미용실,1,1,1,3
11736,s20849736,20849736,룩헤어,1,1,1,3
11737,s13160528,13160528,헤어고레스,1,1,1,3
11738,s35593247,35593247,에디션헤어살롱,1,1,1,3
11739,s1344810282,1344810282,느루헤어,1,1,1,3
11740,s1489705644,1489705644,태후사랑 사당점,1,1,1,3
11741,s1063912751,1063912751,하하헤어샵,1,1,1,3
11742,s209752869,209752869,칼리아헤어샵,1,1,1,3
11743,s1902789175,1902789175,메르시헤어,1,1,1,3
11744,s1327309757,1327309757,CF헤어,1,1,1,3
11745,s30811948,30811948,보니토헤어,1,1,1,3
11746,s38015527,38015527,토토로 헤어,1,1,1,3
11747,s1901371696,1901371696,오인선헤어샵,1,1,1,3
11748,s1133503580,1133503580,블루클럽 공덕점,1,1,1,3
11749,s1664404650,1664404650,에스샵,1,1,1,3
11750,s21892838,21892838,소년이 든 가위,1,1,1,3
11751,s37883235,37883235,소년이든가위,1,1,1,3
11752,s30837365,30837365,살롱드디유,1,1,1,3
11753,s32817436,32817436,퀸즈헤어,1,1,1,3
11754,s20860049,20860049,헤어스토리,1,1,1,3
11755,s35807026,35807026,낫띵앤낫띵 바버샵,1,1,1,3
11756,s1228100183,1228100183,사계헤어,1,1,1,3
11757,s1587844244,1587844244,보니따헤어,1,1,1,3
11758,s1141486987,1141486987,무어,1,1,1,3
11759,s1175214059,1175214059,헬로우헤어,1,1,1,3
11760,s34044134,34044134,황금헤어샵,1,1,1,3
11761,s30986752,30986752,스잔나 헤어살롱,1,1,1,3
11762,s21339810,21339810,헤어살롱비,1,1,1,3
11763,s31898850,31898850,칸타빌헤어,1,1,1,3
11764,s1011937102,1011937102,더헤어,1,1,1,3
11765,s275248038,275248038,헤어샵호야,1,1,1,3
11766,s38590382,38590382,어퍼컷 마포점,1,1,1,3
11767,s21219666,21219666,비앤비헤어샵,1,1,1,3
11768,s12858177,12858177,샤인비앤비,1,1,1,3
11769,s20884725,20884725,비&비헤어,1,1,1,3
11770,s1708189552,1708189552,shytokki 토끼네미용실,1,1,1,3
11771,s20969523,20969523,진헤어,1,1,1,3
11772,s11729938,11729938,블루클럽 만리동점,1,1,1,3
11773,s1419593506,1419593506,버르장머리헤어샵,1,1,1,3
11774,s1638192542,1638192542,바비헤어,1,1,1,3
11775,s1412386659,1412386659,마이헤어,1,1,1,3
11776,s1658470996,1658470996,이지은헤어펌,1,1,1,3
11777,s18134600,18134600,유빈헤어,1,1,1,3
11778,s18764611,18764611,이혜원헤어샵,1,1,1,3
11779,s20886983,20886983,미즈헤어,1,1,1,3
11780,s38531581,38531581,시저시스터살롱,1,1,1,3
11781,s20268351,20268351,장싸롱,1,1,1,3
11782,s35142759,35142759,아인헤어,1,1,1,3
11783,s253090420,253090420,더지오,1,1,1,3
11784,s1689757302,1689757302,로라헤어쌀롱,1,1,1,3
11785,s37264403,37264403,헤어스토리,1,1,1,3
11786,s33562589,33562589,이스트플라워 헤어,1,1,1,3
11787,s1664716506,1664716506,몽끌헤어,1,1,1,3
11788,s1396093156,1396093156,살롱드아론,1,1,1,3
11789,s34557110,34557110,예샵,1,1,1,3
11790,s1282388089,1282388089,정운헤어,1,1,1,3
11791,s35337817,35337817,제시카 인 뉴욕,1,1,1,3
11792,s1109827311,1109827311,지니헤어컷전문,1,1,1,3
11793,s21301564,21301564,태후사랑 망원점,1,1,1,3
11794,s1568392010,1568392010,수정헤어,1,1,1,3
11795,s1341420965,1341420965,행복한 미용실,1,1,1,3
11796,s1513673431,1513673431,헤어아쭈,1,1,1,3
11797,s1336117076,1336117076,이가이헤어,1,1,1,3
11798,s36090960,36090960,136524unique,1,1,1,3
11799,s1525357977,1525357977,한영희헤어샵,1,1,1,3
11800,s37269600,37269600,마르떼헤어,1,1,1,3
11801,s36084433,36084433,새벽,1,1,1,3
11802,s1122714010,1122714010,그림헤어,1,1,1,3
11803,s36324116,36324116,라망데듀 헤어살롱,1,1,1,3
11804,s38251984,38251984,M헤어살롱,1,1,1,3
11805,s485147314,485147314,미미헤어샵,1,1,1,3
11806,s1265015196,1265015196,남성컷트클럽마포점,1,1,1,3
11807,s36404684,36404684,진헤어,1,1,1,3
11808,s34557437,34557437,모드니헤어,1,1,1,3
11809,s36998214,36998214,카멜레온,1,1,1,3
11810,s33252666,33252666,헤어살롱 아뜨리에,1,1,1,3
11811,s34129674,34129674,가온헤어,1,1,1,3
11812,s37555560,37555560,라벨르헤어,1,1,1,3
11813,s33546418,33546418,박철헤어리쉬홍대점,1,1,1,3
11814,s1409612135,1409612135,아씨미용타운,1,1,1,3
11815,s20875627,20875627,성희미용실,1,1,1,3
11816,s1342276917,1342276917,바나바나헤어,1,1,1,3
11817,s20910064,20910064,장호정헤어모드,1,1,1,3
11818,s1376994641,1376994641,김미현헤어,1,1,1,3
11819,s1718099207,1718099207,장미숙헤어클리닉,1,1,1,3
11820,s20917623,20917623,강남미용실,1,1,1,3
11821,s18765893,18765893,오복미용실,1,1,1,3
11822,s20898593,20898593,김송엽헤어샵,1,1,1,3
11823,s19418139,19418139,다운타운미용실,1,1,1,3
11824,s1302867533,1302867533,나성희헤어라인,1,1,1,3
11825,s18765649,18765649,란미용실,1,1,1,3
11826,s20921224,20921224,복지헤어샵,1,1,1,3
11827,s1135277532,1135277532,뉴헤어스타,1,1,1,3
11828,s35023630,35023630,더끌리지헤어,1,1,1,3
11829,s20898610,20898610,닥터헤어,1,1,1,3
11830,s33868661,33868661,이수니헤어,1,1,1,3
11831,s18078189,18078189,김지연미용실,1,1,1,3
11832,s284158772,284158772,소프레사 상암DMC점,1,1,1,3
11833,s20845908,20845908,제이헤어,1,1,1,3
11834,s1637386441,1637386441,Park Chan hair,1,1,1,3
11835,s1919854872,1919854872,W헤어,1,1,1,3
11836,s1050049809,1050049809,끄댕이,1,1,1,3
11837,s38414704,38414704,소울시저스,1,1,1,3
11838,s33965073,33965073,헤어센스,1,1,1,3
11839,s11612637,11612637,쟝피엘헤어 상암점,1,1,1,3
11840,s31394586,31394586,다경미용실,1,1,1,3
11841,s1115937446,1115937446,보보  헤어,1,1,1,3
11842,s18775988,18775988,머리가,1,1,1,3
11843,s13154818,13154818,케이앤케이남성커트,1,1,1,3
11844,s13557983,13557983,건우헤어,1,1,1,3
11845,s36166432,36166432,정헤어,1,1,1,3
11846,s38010753,38010753,S hair,1,1,1,3
11847,s18772757,18772757,최영헤어붐,1,1,1,3
11848,s13126652,13126652,헤어엔조이,1,1,1,3
11849,s32059357,32059357,인스타일,1,1,1,3
11850,s20832976,20832976,금메달미용실,1,1,1,3
11851,s20917663,20917663,헤어수,1,1,1,3
11852,s20430584,20430584,마임헤어마포점,1,1,1,3
11853,s18792117,18792117,박명선헤어,1,1,1,3
11854,s1277922922,1277922922,살롱드블랑쉬,1,1,1,3
11855,s1739561279,1739561279,무드인살롱,1,1,1,3
11856,s20887031,20887031,명품헤어샾,1,1,1,3
11857,s1025856831,1025856831,헤어스토리,1,1,1,3
11858,s1429529169,1429529169,자야미용실,1,1,1,3
11859,s1584653094,1584653094,나이스가이 신대방삼거리역점,1,1,1,3
11860,s1794291692,1794291692,헤어뉴스,1,1,1,3
11861,s1598567809,1598567809,바니헤어,1,1,1,3
11862,s1571294620,1571294620,살롱드5K헤어 장승배기점,1,1,1,3
11863,s37286527,37286527,이쁜머리,1,1,1,3
11864,s1100437863,1100437863,미용실봄,1,1,1,3
11865,s32799735,32799735,와이헤어,1,1,1,3
11866,s1479652388,1479652388,연아헤어,1,1,1,3
11867,s1067712692,1067712692,소울헤어,1,1,1,3
11868,s1924346250,1924346250,비비드제이,1,1,1,3
11869,s1519645733,1519645733,민Je헤어,1,1,1,3
11870,s13156669,13156669,지오헤어클럽,1,1,1,3
11871,s1738435032,1738435032,IMH,1,1,1,3
11872,s1764071190,1764071190,ON헤어,1,1,1,3
11873,s1465043416,1465043416,나이스가이 숭실대역점,1,1,1,3
11874,s244596436,244596436,엘헤어샵,1,1,1,3
11875,s1541535368,1541535368,하루헤어,1,1,1,3
11876,s1723727201,1723727201,조안헤어,1,1,1,3
11877,s1068780862,1068780862,현서스타일,1,1,1,3
11878,s18296898,18296898,유언자미용실,1,1,1,3
11879,s30982440,30982440,블루클럽 상암점,1,1,1,3
11880,sk1722215047,k1722215047,차앤진헤어,1,1,1,3
11881,s1913089113,1913089113,592,1,1,1,3
11882,s37442012,37442012,헤어하우스바이호란,1,1,1,3
11883,s37403034,37403034,심가나미장원,1,1,1,3
11884,s35156236,35156236,치글헤어,1,1,1,3
11885,s1284229963,1284229963,훈스타일,1,1,1,3
11886,s11729930,11729930,블루클럽 귀빈로점,1,1,1,3
11887,s1859930078,1859930078,진미용실,1,1,1,3
11888,s21581916,21581916,비오비,1,1,1,3
11889,s20956083,20956083,IM헤어살롱,1,1,1,3
11890,s18905064,18905064,보브헤어,1,1,1,3
11891,s75039898,75039898,보브헤어,1,1,1,3
11892,s18795014,18795014,보브헤어,1,1,1,3
11893,s1932803272,1932803272,보브헤어,1,1,1,3
11894,s423723709,423723709,보브헤어,1,1,1,3
11895,s1224864946,1224864946,보브미용실,1,1,1,3
11896,s21306270,21306270,살롱드 루시,1,1,1,3
11897,s1157641149,1157641149,아람살롱,1,1,1,3
11898,s1595718795,1595718795,박상국커트 앤 스파,1,1,1,3
11899,s1046103364,1046103364,더헤어앤위그,1,1,1,3
11900,s18354609,18354609,소피아헤어,1,1,1,3
11901,s20879632,20879632,베리따헤어,1,1,1,3
11902,s32572378,32572378,이가정헤어,1,1,1,3
11903,s18793982,18793982,헤어스케치,1,1,1,3
11904,s1539639602,1539639602,김미경헤어,1,1,1,3
11905,s18793615,18793615,김경희헤어,1,1,1,3
11906,s36003170,36003170,J STYLE hair,1,1,1,3
11907,s20388966,20388966,자쓰리헤어 홍대점,1,1,1,3
11908,s737170064,737170064,에뛰드 라운지,1,1,1,3
11909,s1788922714,1788922714,이지헤어,1,1,1,3
11910,s20339395,20339395,안나헤어살롱,1,1,1,3
11911,s11729954,11729954,블루클럽 성산점,1,1,1,3
11912,s33238205,33238205,수헤어,1,1,1,3
11913,s32473464,32473464,지헤어성산점,1,1,1,3
11914,s33636596,33636596,한민경헤어,1,1,1,3
11915,s20836932,20836932,샤론미용실,1,1,1,3
11916,s1888281527,1888281527,스타일헤어,1,1,1,3
11917,s1738953862,1738953862,또또미용실,1,1,1,3
11918,s18806993,18806993,나나미용실,1,1,1,3
11919,s18804258,18804258,태양미용타운,1,1,1,3
11920,s18796623,18796623,이상희헤어모드,1,1,1,3
11921,s37778592,37778592,릿찌헤어,1,1,1,3
11922,s10983326,10983326,정정원 헤어 룩,1,1,1,3
11923,s1160621248,1160621248,헤어팜,1,1,1,3
11924,s1873024835,1873024835,컷팅클럽,1,1,1,3
11925,s1385666499,1385666499,뷰티샵,1,1,1,3
11926,s1388848012,1388848012,미자르헤어,1,1,1,3
11927,s1850105040,1850105040,코코헤어,1,1,1,3
11928,s1946420197,1946420197,힐링헤어,1,1,1,3
11929,s36868352,36868352,이훈ALL30000미용실 구로역점,1,1,1,3
11930,s1266522724,1266522724,헤어짱,1,1,1,3
11931,s37026266,37026266,박엔헤어,1,1,1,3
11932,s1794114831,1794114831,연세이레헤어,1,1,1,3
11933,s1823608698,1823608698,전도서헤어,1,1,1,3
11934,s1933483058,1933483058,김태희헤어샵,1,1,1,3
11935,s37402758,37402758,단미&그린비헤어,1,1,1,3
11936,s19949359,19949359,가위소리,1,1,1,3
11937,s32171324,32171324,수정미용실,1,1,1,3
11938,s1020264451,1020264451,주헤어샵,1,1,1,3
11939,s1035102528,1035102528,머리못하는집,1,1,1,3
11940,s1845028000,1845028000,올리브헤어,1,1,1,3
11941,s1489576278,1489576278,장연서헤어,1,1,1,3
11942,s1090191378,1090191378,월화목금미용실,1,1,1,3
11943,s1413040380,1413040380,미스터바오마리,1,1,1,3
11944,s1884745051,1884745051,헤어뉴스,1,1,1,3
11945,s37568475,37568475,미소헤어,1,1,1,3
11946,s1327751462,1327751462,비에스헤어,1,1,1,3
11947,s1870019131,1870019131,지민헤어,1,1,1,3
11948,s37792696,37792696,토토헤어 온수점,1,1,1,3
11949,s1048812602,1048812602,헤어핏,1,1,1,3
11950,s1242424007,1242424007,미담헤어,1,1,1,3
11951,s1550277481,1550277481,태후사랑 궁동점,1,1,1,3
11952,s20872331,20872331,바비걸헤어,1,1,1,3
11953,s36406537,36406537,도로시헤어,1,1,1,3
11954,s1722780175,1722780175,태후사랑,1,1,1,3
11955,s419361081,419361081,JY헤어 연지점,1,1,1,3
11956,s1711241265,1711241265,제이와이헤어연지점,1,1,1,3
11957,s34355627,34355627,샤르망헤어,1,1,1,3
11958,s37089778,37089778,살롱드제니,1,1,1,3
11959,s1498268781,1498268781,오타쿠헤어살롱,1,1,1,3
11960,s1285303523,1285303523,미장원1998,1,1,1,3
11961,s1139803013,1139803013,이훈plan오류,1,1,1,3
11962,s1064658823,1064658823,모나리자브로우,1,1,1,3
11963,s1290296884,1290296884,가위소리,1,1,1,3
11964,s1371457542,1371457542,헤어파크,1,1,1,3
11965,s20849299,20849299,미짱헤어,1,1,1,3
11966,s20852859,20852859,김영애헤어포인트,1,1,1,3
11967,s18490228,18490228,미앤미,1,1,1,3
11968,s1546177512,1546177512,이지율뷰티,1,1,1,3
11969,s1446419029,1446419029,레드헤어쿨 고척점,1,1,1,3
11970,s1001039240,1001039240,향기속으로 천연염색,1,1,1,3
11971,s1017104815,1017104815,라헤어,1,1,1,3
11972,s37854568,37854568,아지트헤어,1,1,1,3
11973,s20925662,20925662,헤어포인트,1,1,1,3
11974,s20829778,20829778,헤어민트,1,1,1,3
11975,s496999523,496999523,토리헤어 개봉역점,1,1,1,3
11976,s820736352,820736352,케이헤어 미용실,1,1,1,3
11977,s825323946,825323946,나이스가이 구로디지털점,1,1,1,3
11978,s565144290,565144290,헬로우컷 고척사거리점,1,1,1,3
11979,s1511874604,1511874604,민헤어,1,1,1,3
11980,s940567423,940567423,헤어끼,1,1,1,3
11981,s1020681560,1020681560,구뜨헤어살롱,1,1,1,3
11982,s1237776745,1237776745,살롱드주아,1,1,1,3
11983,s33212702,33212702,머리물들이는날,1,1,1,3
11984,s1549842418,1549842418,다윤헤어,1,1,1,3
11985,s1486527082,1486527082,감동헤어,1,1,1,3
11986,s1445299338,1445299338,보이스클럽,1,1,1,3
11987,s1673344874,1673344874,살롱드미가,1,1,1,3
11988,s1005938511,1005938511,마라조,1,1,1,3
11989,s20925635,20925635,베누스헤어,1,1,1,3
11990,s1173581208,1173581208,안나헤어샵,1,1,1,3
11991,s1139068549,1139068549,공감헤어,1,1,1,3
11992,s20884002,20884002,코코헤어,1,1,1,3
11993,s1207844040,1207844040,샤론미용타운,1,1,1,3
11994,s20841461,20841461,서여미장,1,1,1,3
11995,s1925537530,1925537530,릴리헤어,1,1,1,3
11996,s1873493786,1873493786,수헤어샵,1,1,1,3
11997,s20825740,20825740,소피아,1,1,1,3
11998,sk18433229,k18433229,제이피씨,1,1,1,3
11999,s1252512641,1252512641,차칸헤어,1,1,1,3
12000,s1743090155,1743090155,리안헤어 고척시장점,1,1,1,3
12001,s252276649,252276649,머리못하는집,1,1,1,3
12002,s1723792898,1723792898,금모래헤어,1,1,1,3
12003,s1543213992,1543213992,선헤어,1,1,1,3
12004,s38667869,38667869,자유느낌,1,1,1,3
12005,s38501169,38501169,B&J HAIR,1,1,1,3
12006,s38265323,38265323,위자드헤어,1,1,1,3
12007,s38328328,38328328,와바헤어,1,1,1,3
12008,s1943050493,1943050493,바비헤어,1,1,1,3
12009,s38452163,38452163,헤어 마루,1,1,1,3
12010,s1120640628,1120640628,중앙헤어센스,1,1,1,3
12011,s1782339720,1782339720,우리헤어샵,1,1,1,3
12012,s1015179780,1015179780,머리못하는집 개봉134호점,1,1,1,3
12013,s607928616,607928616,핸썸가이,1,1,1,3
12014,s1110818655,1110818655,박지수헤어,1,1,1,3
12015,s20856884,20856884,헤어카페희망,1,1,1,3
12016,s1459050026,1459050026,엘가헤어,1,1,1,3
12017,s1745447923,1745447923,라움헤어,1,1,1,3
12018,s38549376,38549376,택시헤어,1,1,1,3
12019,s20929407,20929407,예쁜머리,1,1,1,3
12020,s1989200338,1989200338,동원미용실,1,1,1,3
12021,s32101454,32101454,하은헤어샵,1,1,1,3
12022,s1234756960,1234756960,햇살미장,1,1,1,3
12023,s1845110419,1845110419,헤어클럽,1,1,1,3
12024,s1380025513,1380025513,신데렐라,1,1,1,3
12025,s20925576,20925576,머리쟁이,1,1,1,3
12026,s36996104,36996104,리안헤어 개봉역점,1,1,1,3
12027,s34356348,34356348,헤어짱,1,1,1,3
12028,s38548276,38548276,수헤어,1,1,1,3
12029,s1927175976,1927175976,수미용실,1,1,1,3
12030,s20969677,20969677,윤용애헤어갤러리,1,1,1,3
12031,s35044891,35044891,바니헤어,1,1,1,3
12032,s20910432,20910432,홍미애꾸미지오,1,1,1,3
12033,s1231253345,1231253345,어썸제이헤어,1,1,1,3
12034,s20933249,20933249,헤어포인트,1,1,1,3
12035,s36005239,36005239,천인미용실,1,1,1,3
12036,s1684782828,1684782828,아우라헤어,1,1,1,3
12037,s1055970752,1055970752,힐링헤어,1,1,1,3
12038,s20902772,20902772,북경미용실,1,1,1,3
12039,s20070682,20070682,타마루헤어,1,1,1,3
12040,s20856965,20856965,양미경헤어라인,1,1,1,3
12041,s19996756,19996756,헤어이마쥬,1,1,1,3
12042,s20856834,20856834,유진헤어,1,1,1,3
12043,s20918066,20918066,서림미용실,1,1,1,3
12044,s20933317,20933317,엘림미용실,1,1,1,3
12045,s1607861471,1607861471,스마일헤어샵,1,1,1,3
12046,s1903582367,1903582367,신데렐라미용실,1,1,1,3
12047,s18463698,18463698,미즈헤어샵,1,1,1,3
12048,s1472517334,1472517334,헤어톡,1,1,1,3
12049,s36740487,36740487,쉬크헤어살롱,1,1,1,3
12050,s1029239360,1029239360,쉬크헤어,1,1,1,3
12051,s20833563,20833563,센스헤어,1,1,1,3
12052,s1954187510,1954187510,고영민헤어,1,1,1,3
12053,s1848455903,1848455903,정쌤헤어,1,1,1,3
12054,s1531437370,1531437370,사자머리,1,1,1,3
12055,s990066824,990066824,세라헤어샵,1,1,1,3
12056,s20918086,20918086,헤어홀릭,1,1,1,3
12057,s20825903,20825903,김혜리헤어살롱,1,1,1,3
12058,s20856840,20856840,여우헤어,1,1,1,3
12059,s20872246,20872246,헤어디자인,1,1,1,3
12060,s20914406,20914406,가인헤어,1,1,1,3
12061,s19409144,19409144,헤어포스,1,1,1,3
12062,s36526166,36526166,린헤어,1,1,1,3
12063,s1125754052,1125754052,우수연헤어샵 고척점,1,1,1,3
12064,s1241189483,1241189483,여우헤어,1,1,1,3
12065,s37943721,37943721,헤어바이헤이,1,1,1,3
12066,s1107730304,1107730304,나윤헤어,1,1,1,3
12067,s34356565,34356565,댕기헤어,1,1,1,3
12068,s1744752524,1744752524,비즈헤어,1,1,1,3
12069,s1030392831,1030392831,태후사랑 개봉1호점,1,1,1,3
12070,s1809999761,1809999761,한은혜 미용실,1,1,1,3
12071,s1101339448,1101339448,줄리헤어,1,1,1,3
12072,s1840501619,1840501619,Hair by 윤,1,1,1,3
12073,s1869304437,1869304437,까치미용실,1,1,1,3
12074,s35840337,35840337,이슈헤어,1,1,1,3
12075,s37429877,37429877,연헤어,1,1,1,3
12076,s621252656,621252656,장화홍련헤어샵,1,1,1,3
12077,s20887645,20887645,천사헤어구로점,1,1,1,3
12078,s21129654,21129654,JM 헤어,1,1,1,3
12079,s1504485330,1504485330,비비안리헤어 신도림2호점,1,1,1,3
12080,s1761979007,1761979007,태후사랑 오류2동점,1,1,1,3
12081,s1175391923,1175391923,헤어루시,1,1,1,3
12082,s1001153710,1001153710,시상미용실,1,1,1,3
12083,s1669472931,1669472931,머리못하는집 신도림108호점,1,1,1,3
12084,s543307948,543307948,리즈헤어,1,1,1,3
12085,s1537418512,1537418512,포맨,1,1,1,3
12086,s1162522052,1162522052,사랑미용실,1,1,1,3
12087,s36005240,36005240,지연헤어샵,1,1,1,3
12088,s1264219888,1264219888,까꼬샵,1,1,1,3
12089,s1867556073,1867556073,헤어이즈,1,1,1,3
12090,s30805739,30805739,최지혜헤어story,1,1,1,3
12091,s36417028,36417028,아이유헤어,1,1,1,3
12092,s38557663,38557663,나이스가이 구일점,1,1,1,3
12093,s1128700973,1128700973,길인미용실,1,1,1,3
12094,s34357545,34357545,미헤어라인,1,1,1,3
12095,s32278258,32278258,현s 헤어,1,1,1,3
12096,s37822609,37822609,참빛머리결,1,1,1,3
12097,s1983586710,1983586710,클로버헤어,1,1,1,3
12098,s33625535,33625535,까미헤어,1,1,1,3
12099,s1777787456,1777787456,샤방샤방헤어샵,1,1,1,3
12100,s1595988501,1595988501,영헤어,1,1,1,3
12101,s441182733,441182733,스타일헤어,1,1,1,3
12102,s37642636,37642636,모드니헤어,1,1,1,3
12103,s1790622423,1790622423,더헤어,1,1,1,3
12104,s1522568273,1522568273,더헤어,1,1,1,3
12105,s1712931357,1712931357,카리스,1,1,1,3
12106,s37923683,37923683,민헤어,1,1,1,3
12107,s20880203,20880203,케이헤어,1,1,1,3
12108,s1370634986,1370634986,나무헤어,1,1,1,3
12109,s38003585,38003585,이화헤어,1,1,1,3
12110,s38259203,38259203,w헤어,1,1,1,3
12111,s37721108,37721108,가본헤어,1,1,1,3
12112,s355997406,355997406,주주헤어,1,1,1,3
12113,s38537907,38537907,친절한미용실,1,1,1,3
12114,s64530466,64530466,이훈ALL30000 시흥점,1,1,1,3
12115,s1192524859,1192524859,예쁜머리SHOP,1,1,1,3
12116,s51872202,51872202,보스몽헤어,1,1,1,3
12117,s1835125452,1835125452,휴&미 헤어,1,1,1,3
12118,s775531109,775531109,멋쟁이미장원,1,1,1,3
12119,s1554169267,1554169267,이레헤어,1,1,1,3
12120,s1428310055,1428310055,헤어포맨,1,1,1,3
12121,s1071986748,1071986748,오땡큐 시흥점,1,1,1,3
12122,s712322140,712322140,410봄헤어,1,1,1,3
12123,s749377829,749377829,블루클럽 금천구청점,1,1,1,3
12124,s1478427183,1478427183,젠틀맨 본점,1,1,1,3
12125,s1757989079,1757989079,기모헤어,1,1,1,3
12126,s290509642,290509642,모모헤어,1,1,1,3
12127,s1369287030,1369287030,살롱오현수바이티지보이,1,1,1,3
12128,s1294182070,1294182070,m2 hair,1,1,1,3
12129,s1317523189,1317523189,미미 미장원,1,1,1,3
12130,s1203550932,1203550932,까망머리,1,1,1,3
12131,s919307754,919307754,가위소리뷰티헤어살롱,1,1,1,3
12132,s1216751061,1216751061,S헤어,1,1,1,3
12133,s1212176831,1212176831,희영헤어샵,1,1,1,3
12134,s1470627850,1470627850,준헤어로,1,1,1,3
12135,s1029674496,1029674496,가영미용실,1,1,1,3
12136,s20115098,20115098,헤어핀,1,1,1,3
12137,s34412990,34412990,남자만들기,1,1,1,3
12138,s37413930,37413930,Y헤어샵,1,1,1,3
12139,s1059276533,1059276533,바니헤어,1,1,1,3
12140,s36798061,36798061,강혜살롱,1,1,1,3
12141,s18989148,18989148,리헤어갤러리,1,1,1,3
12142,s1584873682,1584873682,홍콩헤어 3호점,1,1,1,3
12143,s840030551,840030551,남자들의세상시흥점,1,1,1,3
12144,s20911342,20911342,비쥬헤어,1,1,1,3
12145,s36961066,36961066,윤희헤어,1,1,1,3
12146,s33210037,33210037,지민헤어트렌드,1,1,1,3
12147,s11607021,11607021,신주꾸헤어,1,1,1,3
12148,s289288699,289288699,신주꾸헤어,1,1,1,3
12149,s37341824,37341824,EJ미용실,1,1,1,3
12150,s1651733117,1651733117,박서현헤어,1,1,1,3
12151,s37123114,37123114,단미헤어,1,1,1,3
12152,s33021991,33021991,헤어바이비,1,1,1,3
12153,s20857601,20857601,현헤어아트,1,1,1,3
12154,s1067477182,1067477182,헤어다,1,1,1,3
12155,s1436828703,1436828703,바비헤어,1,1,1,3
12156,s411546340,411546340,머리쟁이,1,1,1,3
12157,s18982996,18982996,머리사랑,1,1,1,3
12158,s1077764158,1077764158,캐슬헤어,1,1,1,3
12159,s1459859915,1459859915,비비드미용실,1,1,1,3
12160,s1037475032,1037475032,세이프존,1,1,1,3
12161,s1037419132,1037419132,김다희 헤어,1,1,1,3
12162,s1521309819,1521309819,아는혁님 헤어샵,1,1,1,3
12163,s1988086957,1988086957,우림헤어,1,1,1,3
12164,s1766412621,1766412621,아뜰리엔,1,1,1,3
12165,s37349761,37349761,라보떼헤어,1,1,1,3
12166,s1337516013,1337516013,버블스토리 롯데캐슬점,1,1,1,3
12167,s1698393405,1698393405,쎄이투 염색샵,1,1,1,3
12168,s1713550271,1713550271,유니헤어,1,1,1,3
12169,s1117114332,1117114332,참기분좋은날,1,1,1,3
12170,s1925831713,1925831713,낭만헤어,1,1,1,3
12171,s1429933584,1429933584,써니미용실,1,1,1,3
12172,s1442011761,1442011761,영미용실,1,1,1,3
12173,s1736778921,1736778921,김민재미용실,1,1,1,3
12174,s1755667654,1755667654,연화미용실,1,1,1,3
12175,s18004864,18004864,미스도로시,1,1,1,3
12176,s21855096,21855096,이연정헤어,1,1,1,3
12177,s1555035743,1555035743,더샴푸헤어,1,1,1,3
12178,s20903709,20903709,마리헤어,1,1,1,3
12179,s1414178684,1414178684,바글바글헤어,1,1,1,3
12180,s1511118381,1511118381,윤슬헤어,1,1,1,3
12181,s20846140,20846140,애드미헤어,1,1,1,3
12182,s1659476634,1659476634,하나 미용실,1,1,1,3
12183,s738777262,738777262,헤어짱,1,1,1,3
12184,s1462120822,1462120822,노희헤어,1,1,1,3
12185,s1074570359,1074570359,나이스가이 가산디지털단지역점,1,1,1,3
12186,s1972151341,1972151341,주주헤어,1,1,1,3
12187,s1136960545,1136960545,핑크머리,1,1,1,3
12188,s1956573555,1956573555,브라보헤어,1,1,1,3
12189,s1009654563,1009654563,서준헤어리더,1,1,1,3
12190,s1574999006,1574999006,JK헤어,1,1,1,3
12191,s38692256,38692256,오향수헤어라인,1,1,1,3
12192,s1672429043,1672429043,이영주헤어,1,1,1,3
12193,s1984786430,1984786430,머리하는날,1,1,1,3
12194,s1142575865,1142575865,헤어샵,1,1,1,3
12195,s1346506220,1346506220,바비헤어,1,1,1,3
12196,s1401609865,1401609865,미장원헤어샵,1,1,1,3
12197,s20838497,20838497,까끌레뽀끌레헤어샵,1,1,1,3
12198,s1439144935,1439144935,민헤어,1,1,1,3
12199,s20846328,20846328,디올헤어,1,1,1,3
12200,s37475400,37475400,구피샵 독산점,1,1,1,3
12201,s33267338,33267338,나디아헤어,1,1,1,3
12202,s1587798022,1587798022,다소니헤어,1,1,1,3
12203,s1460468385,1460468385,희정헤어,1,1,1,3
12204,s1413601097,1413601097,보니헤어,1,1,1,3
12205,s1852573303,1852573303,티아라헤어,1,1,1,3
12206,s1930630640,1930630640,쿨헤어,1,1,1,3
12207,s1276690161,1276690161,다옴헤어,1,1,1,3
12208,s1603852867,1603852867,염색쁜,1,1,1,3
12209,s1959878430,1959878430,이훈plan30000,1,1,1,3
12210,s1240387518,1240387518,제이염색,1,1,1,3
12211,s1101653742,1101653742,헤어봄,1,1,1,3
12212,s994315025,994315025,TOP1 헤어,1,1,1,3
12213,s1096719057,1096719057,원헤어,1,1,1,3
12214,s992435130,992435130,김환헤어트렌드독산본점,1,1,1,3
12215,s59334094,59334094,쥬니헤어,1,1,1,3
12216,s524006420,524006420,탑원헤어샵,1,1,1,3
12217,s1410698318,1410698318,김환헤어트랜드,1,1,1,3
12218,s12756450,12756450,서정미용가구,1,1,1,3
12219,s1380518966,1380518966,멋진남자,1,1,1,3
12220,s1752478832,1752478832,로핌헤어,1,1,1,3
12221,s13141460,13141460,빨강여우,1,1,1,3
12222,s240252583,240252583,홍콩헤어,1,1,1,3
12223,s1664248943,1664248943,지지헤어,1,1,1,3
12224,s1467134065,1467134065,태후사랑 구로시장점,1,1,1,3
12225,s37362810,37362810,명주미용실,1,1,1,3
12226,s1547194428,1547194428,안녕 헤어,1,1,1,3
12227,s1428284759,1428284759,에스더헤어,1,1,1,3
12228,s1138329572,1138329572,진헤어샾,1,1,1,3
12229,s1128641636,1128641636,친환경머리염색,1,1,1,3
12230,s1097049943,1097049943,란헤어,1,1,1,3
12231,s1801787426,1801787426,헤어피플,1,1,1,3
12232,s1899562012,1899562012,무지개미용실,1,1,1,3
12233,s1878075185,1878075185,김미장원,1,1,1,3
12234,s1798459312,1798459312,바이젬마헤어,1,1,1,3
12235,s1455642061,1455642061,오땡큐,1,1,1,3
12236,s1403876610,1403876610,태후사랑고척본점,1,1,1,3
12237,s1219103691,1219103691,태후사랑고척1동,1,1,1,3
12238,s1006702321,1006702321,민앤루시헤어,1,1,1,3
12239,s20933460,20933460,미성미용실,1,1,1,3
12240,s11729750,11729750,블루클럽 구로공구상가점,1,1,1,3
12241,s21892786,21892786,가미헤어,1,1,1,3
12242,s18475920,18475920,나비미용실,1,1,1,3
12243,s36005241,36005241,월드이용원,1,1,1,3
12244,s20895318,20895318,모즈n헤어,1,1,1,3
12245,s1477793253,1477793253,아르떼3.5,1,1,1,3
12246,s1400537300,1400537300,가람미용실,1,1,1,3
12247,s855081951,855081951,윤모던헤어,1,1,1,3
12248,s20834430,20834430,조이맨남성컷,1,1,1,3
12249,s726495783,726495783,쥬뗌므헤어아트,1,1,1,3
12250,s1180776504,1180776504,장머리방,1,1,1,3
12251,s877506669,877506669,예진헤어샵,1,1,1,3
12252,s657925674,657925674,머리못하는집 독산61호점,1,1,1,3
12253,s1378025347,1378025347,Hair studio N 시흥점,1,1,1,3
12254,s726973184,726973184,김진헤어샵,1,1,1,3
12255,s36717737,36717737,비엔이미용실 홈플러스금천점,1,1,1,3
12256,s38296666,38296666,The끌림헤어,1,1,1,3
12257,s57593090,57593090,길미용실,1,1,1,3
12258,s1177967874,1177967874,김은주미용실,1,1,1,3
12259,s706496525,706496525,썬헤어클럽,1,1,1,3
12260,s38299606,38299606,헤어스타일,1,1,1,3
12261,s1627842304,1627842304,HAIR by팡팡,1,1,1,3
12262,s1037738621,1037738621,라임헤어,1,1,1,3
12263,s20822523,20822523,이정아헤어샵,1,1,1,3
12264,s36997193,36997193,머리못하는집 가산점,1,1,1,3
12265,s1211011474,1211011474,코디헤어 시흥점,1,1,1,3
12266,s31400703,31400703,헤어박스,1,1,1,3
12267,s1967768624,1967768624,단발머리,1,1,1,3
12268,s645381957,645381957,여성시대,1,1,1,3
12269,s20918886,20918886,미샵,1,1,1,3
12270,s20861626,20861626,오즈헤어,1,1,1,3
12271,s947582058,947582058,빨강머리앤,1,1,1,3
12272,s100645775,100645775,라면머리,1,1,1,3
12273,s20922705,20922705,머리세계헤어샵,1,1,1,3
12274,s1470212129,1470212129,헤어천국,1,1,1,3
12275,s20842235,20842235,숙녀미용실,1,1,1,3
12276,s12922264,12922264,안옥희아스픽헤어,1,1,1,3
12277,s18536699,18536699,수헤어,1,1,1,3
12278,s19409894,19409894,현진미용실,1,1,1,3
12279,s20938110,20938110,우리미용실,1,1,1,3
12280,s930165723,930165723,김숙영헤어연출,1,1,1,3
12281,s38420058,38420058,준헤어,1,1,1,3
12282,s18986973,18986973,서탑헤어,1,1,1,3
12283,s20834428,20834428,황금미용실,1,1,1,3
12284,s1156522866,1156522866,머리사랑,1,1,1,3
12285,s1959675188,1959675188,샤인샵,1,1,1,3
12286,s790742018,790742018,동방미용실,1,1,1,3
12287,s1741168162,1741168162,송철헤어샵,1,1,1,3
12288,s21794980,21794980,머리가,1,1,1,3
12289,s1222131407,1222131407,꼬맹뽀글집,1,1,1,3
12290,s949591399,949591399,쎄븐미용타운,1,1,1,3
12291,s18984921,18984921,토탈헤어,1,1,1,3
12292,s1116257973,1116257973,카라헤어,1,1,1,3
12293,s18970394,18970394,헤어비타민,1,1,1,3
12294,s1327404949,1327404949,헤즈헤어,1,1,1,3
12295,s18970860,18970860,새창조헤어센스,1,1,1,3
12296,s36005245,36005245,새미나 미용실,1,1,1,3
12297,s20860589,20860589,수민머리방,1,1,1,3
12298,s36005232,36005232,까망머리방,1,1,1,3
12299,s1451210042,1451210042,행운헤어샾,1,1,1,3
12300,s20860610,20860610,임금이O2미용실,1,1,1,3
12301,s20849223,20849223,수지미용실,1,1,1,3
12302,s18491648,18491648,박영숙헤어샵,1,1,1,3
12303,s20929470,20929470,로사리아헤어피부미용실,1,1,1,3
12304,s1190958459,1190958459,나나헤어라인,1,1,1,3
12305,s1159729017,1159729017,에스더미용실,1,1,1,3
12306,s20876125,20876125,박헤어모드,1,1,1,3
12307,s1518397780,1518397780,그린미용실,1,1,1,3
12308,s12963340,12963340,깍구뽁구미용실,1,1,1,3
12309,s20860794,20860794,세리미용실,1,1,1,3
12310,s20914439,20914439,머리하는날,1,1,1,3
12311,s1063100181,1063100181,나드리헤어,1,1,1,3
12312,s20856925,20856925,다솜미용실,1,1,1,3
12313,s20856749,20856749,샤론헤어아트,1,1,1,3
12314,s20910683,20910683,스칼렛헤어시티,1,1,1,3
12315,s20937127,20937127,새로본미용실,1,1,1,3
12316,s20914344,20914344,이관순미용실,1,1,1,3
12317,s18490226,18490226,안인숙미용실,1,1,1,3
12318,s1401441702,1401441702,셀라미용실,1,1,1,3
12319,s1044953974,1044953974,박용진헤어아트,1,1,1,3
12320,s20841546,20841546,느낌있는미용실,1,1,1,3
12321,s1920809796,1920809796,민재미용실,1,1,1,3
12322,s20876169,20876169,헤어갤러리여경,1,1,1,3
12323,s1160109280,1160109280,가위손헤어샵,1,1,1,3
12324,s1054403488,1054403488,일마레미용실,1,1,1,3
12325,s20891390,20891390,세이브헤어샵,1,1,1,3
12326,s20845262,20845262,이태리헤어,1,1,1,3
12327,s20864644,20864644,챠밍헤어방,1,1,1,3
12328,s20829746,20829746,소망미용실,1,1,1,3
12329,s1264427319,1264427319,박철헤어칼라,1,1,1,3
12330,s18959970,18959970,란미용실,1,1,1,3
12331,s20910551,20910551,고개미용타운,1,1,1,3
12332,s20880207,20880207,윤헤어펌,1,1,1,3
12333,s34357789,34357789,우리미용실,1,1,1,3
12334,s13150617,13150617,송미용실,1,1,1,3
12335,s1857995759,1857995759,주나헤어리더,1,1,1,3
12336,s20880256,20880256,유정헤어,1,1,1,3
12337,s18967637,18967637,허지원머리방,1,1,1,3
12338,s1125805462,1125805462,솔노명헤어라인,1,1,1,3
12339,s18494082,18494082,머리풍경,1,1,1,3
12340,s1115271163,1115271163,윤진헤어,1,1,1,3
12341,s18962076,18962076,에코미플러스구로점,1,1,1,3
12342,s1517658755,1517658755,수앤수헤어,1,1,1,3
12343,s1158671409,1158671409,Style hair view,1,1,1,3
12344,s1478366540,1478366540,미시헤어클럽,1,1,1,3
12345,s20864467,20864467,헤어앤,1,1,1,3
12346,s1276770161,1276770161,미즈헤어,1,1,1,3
12347,s20895258,20895258,영미용실,1,1,1,3
12348,s1627631698,1627631698,이윤주헤어팜,1,1,1,3
12349,sk1112449125,k1112449125,가위헤어,1,1,1,3
12350,s20880219,20880219,선영의상실,1,1,1,3
12351,s197187108,197187108,이레헤어샵,1,1,1,3
12352,s1954860419,1954860419,강녕미용실,1,1,1,3
12353,s18958110,18958110,조장가헤어샵,1,1,1,3
12354,s18963492,18963492,모나리자미용실,1,1,1,3
12355,s20847998,20847998,김연옥헤어샵,1,1,1,3
12356,s18480893,18480893,김혜경미용실,1,1,1,3
12357,s1108881950,1108881950,연화헤어샵,1,1,1,3
12358,s20902909,20902909,머리때문에미친사람들,1,1,1,3
12359,s1392016216,1392016216,힐링컬헤어샵,1,1,1,3
12360,s19412802,19412802,채미란미용실,1,1,1,3
12361,s1651609728,1651609728,스타헤어샵,1,1,1,3
12362,s18957490,18957490,헤어매직미용실,1,1,1,3
12363,s20914295,20914295,세트헤어,1,1,1,3
12364,s18478685,18478685,서민정헤어모드,1,1,1,3
12365,s1280938975,1280938975,미인헤어커커,1,1,1,3
12366,s1451966250,1451966250,김민경미용실,1,1,1,3
12367,s36005228,36005228,이화칼라헤어,1,1,1,3
12368,s18480897,18480897,쿨헤어,1,1,1,3
12369,s18964518,18964518,24시헤어샵,1,1,1,3
12370,s1752354147,1752354147,리오헤어샵,1,1,1,3
12371,s37662995,37662995,JUST CUT,1,1,1,3
12372,s34321449,34321449,컷트클럽,1,1,1,3
12373,s20925841,20925841,핸썸가이,1,1,1,3
12374,s35949390,35949390,라벨르헤어,1,1,1,3
12375,s1083297463,1083297463,미랑컬미용실,1,1,1,3
12376,s1615764668,1615764668,박소현헤어,1,1,1,3
12377,s18480890,18480890,점프쿨헤어,1,1,1,3
12378,s1147871548,1147871548,가위소리,1,1,1,3
12379,s36005243,36005243,쿨가이남구로역점,1,1,1,3
12380,s19412416,19412416,희헤어샵,1,1,1,3
12381,s1833841164,1833841164,듀크헤어,1,1,1,3
12382,s1969245248,1969245248,헤어스토리,1,1,1,3
12383,s20821738,20821738,이레미용실,1,1,1,3
12384,s20837658,20837658,허브헤어샵,1,1,1,3
12385,s1255978413,1255978413,박용미헤어커커,1,1,1,3
12386,s18960738,18960738,서울미용실,1,1,1,3
12387,s1355755327,1355755327,인생미용실,1,1,1,3
12388,s1504947010,1504947010,나라헤어갤러리,1,1,1,3
12389,s1137018650,1137018650,더민헤어,1,1,1,3
12390,s977547143,977547143,한스헤어,1,1,1,3
12391,s1520064272,1520064272,수영헤어,1,1,1,3
12392,s1700234010,1700234010,퀸헤어필,1,1,1,3
12393,s34333191,34333191,예쁜머리,1,1,1,3
12394,s1356955783,1356955783,WE헤어 중곡점,1,1,1,3
12395,s1508272233,1508272233,모비치,1,1,1,3
12396,s20780599,20780599,리시오헤어,1,1,1,3
12397,s1306989379,1306989379,솔 헤어,1,1,1,3
12398,s1911531119,1911531119,남성헤어샵베테랑,1,1,1,3
12399,s1752531117,1752531117,청춘헤어,1,1,1,3
12400,s1733858283,1733858283,살롱드뮤즈,1,1,1,3
12401,s1354126772,1354126772,헤어바이원,1,1,1,3
12402,s1586455329,1586455329,늘 헤어,1,1,1,3
12403,s1678517698,1678517698,채현헤어샵,1,1,1,3
12404,s1615616225,1615616225,다미헤어,1,1,1,3
12405,s1965079084,1965079084,노네임헤어살롱,1,1,1,3
12406,s13158594,13158594,펌앤컷,1,1,1,3
12407,s20909013,20909013,나라헤어,1,1,1,3
12408,s1922282688,1922282688,자이헤어,1,1,1,3
12409,s20927915,20927915,아름다운머리,1,1,1,3
12410,s36864696,36864696,퍼플헤어,1,1,1,3
12411,s1644599979,1644599979,한빛미용실,1,1,1,3
12412,s20863016,20863016,김현애미용실,1,1,1,3
12413,s17991382,17991382,이화미용,1,1,1,3
12414,s1652291816,1652291816,Stay101,1,1,1,3
12415,s1114005688,1114005688,라온헤어,1,1,1,3
12416,s1249393118,1249393118,리리스타미용실,1,1,1,3
12417,s1020863552,1020863552,컷&맨,1,1,1,3
12418,s1576542446,1576542446,JC남성커트,1,1,1,3
12419,s1858268212,1858268212,미니스 컷,1,1,1,3
12420,s1824208732,1824208732,유앤헤어,1,1,1,3
12421,s1838900803,1838900803,오땡큐,1,1,1,3
12422,s1379142726,1379142726,라엘헤어,1,1,1,3
12423,s1464367906,1464367906,클래식헤어샾,1,1,1,3
12424,s1361591512,1361591512,스타헤어,1,1,1,3
12425,s20943381,20943381,스타헤어샵,1,1,1,3
12426,s33409846,33409846,헤어프로포즈,1,1,1,3
12427,s1396931870,1396931870,장살롱,1,1,1,3
12428,s1945479394,1945479394,헤어쥬키,1,1,1,3
12429,s1590861847,1590861847,볼륨헤어,1,1,1,3
12430,s1325693362,1325693362,더 perm 헤어,1,1,1,3
12431,s1613162649,1613162649,벨롱헤어,1,1,1,3
12432,s12772145,12772145,라인스헤어,1,1,1,3
12433,s36005247,36005247,수향미용실,1,1,1,3
12434,s18965461,18965461,유해진미용실,1,1,1,3
12435,s20842272,20842272,은경미용실,1,1,1,3
12436,s1830984276,1830984276,연길미용실,1,1,1,3
12437,s1458901378,1458901378,시대미용,1,1,1,3
12438,s38445694,38445694,카라앤헤어,1,1,1,3
12439,s20911461,20911461,오거리미용실,1,1,1,3
12440,s31400748,31400748,꽃님미용실,1,1,1,3
12441,s20902897,20902897,또또와미용실,1,1,1,3
12442,s11628727,11628727,여우단장헤어샵,1,1,1,3
12443,s1963292373,1963292373,고은헤어,1,1,1,3
12444,s1909291638,1909291638,로사헤어,1,1,1,3
12445,s1709897130,1709897130,좋은날헤어샵,1,1,1,3
12446,s35891297,35891297,숲,1,1,1,3
12447,s20891389,20891389,라인헤어,1,1,1,3
12448,s20837588,20837588,우성헤어샵,1,1,1,3
12449,s1297161100,1297161100,조윤정헤어샵,1,1,1,3
12450,s21904990,21904990,살롱드샤름,1,1,1,3
12451,s20856769,20856769,JC헤어,1,1,1,3
12452,s20853016,20853016,아름미용실,1,1,1,3
12453,s1081839646,1081839646,만민헤어샵,1,1,1,3
12454,s20933225,20933225,영주미용실,1,1,1,3
12455,s20880143,20880143,금발미용세상,1,1,1,3
12456,s18451209,18451209,엔젤헤어샵,1,1,1,3
12457,s36005246,36005246,은하미용실,1,1,1,3
12458,s20872356,20872356,쎄븐미용실,1,1,1,3
12459,s13151827,13151827,미샵 구로시장점,1,1,1,3
12460,s11857208,11857208,온천미용실,1,1,1,3
12461,s20868637,20868637,솔로몬미용실,1,1,1,3
12462,s20880038,20880038,반도미용실,1,1,1,3
12463,s20899050,20899050,비녀헤어라인,1,1,1,3
12464,s20872404,20872404,송이미용실,1,1,1,3
12465,s20837647,20837647,경미용실,1,1,1,3
12466,s20872303,20872303,공주만들기,1,1,1,3
12467,s18502357,18502357,이태리미용실,1,1,1,3
12468,s13175964,13175964,최가을헤어드레서 가산점,1,1,1,3
12469,s237216250,237216250,애플헤어,1,1,1,3
12470,s18965783,18965783,빠리헤어샵,1,1,1,3
12471,s37634035,37634035,이준성헤어,1,1,1,3
12472,s845289414,845289414,베스트남성전문컷,1,1,1,3
12473,s1551115773,1551115773,대성머리나라,1,1,1,3
12474,s1456630071,1456630071,머리이야기,1,1,1,3
12475,s20918009,20918009,금홍미용실,1,1,1,3
12476,s1439992432,1439992432,왕눈이헤어,1,1,1,3
12477,s20914370,20914370,토탈헤어샵,1,1,1,3
12478,s1114248318,1114248318,정숙헤어샵,1,1,1,3
12479,s20940885,20940885,머리사랑,1,1,1,3
12480,s1125776324,1125776324,현정헤어샵,1,1,1,3
12481,s20857247,20857247,세븐원미용실,1,1,1,3
12482,s766428195,766428195,헤어랑,1,1,1,3
12483,s1931507504,1931507504,채연프로헤어,1,1,1,3
12484,s20902908,20902908,소연미용실,1,1,1,3
12485,s20895187,20895187,김지민헤어라인,1,1,1,3
12486,s20895296,20895296,진헤어샵,1,1,1,3
12487,s20895184,20895184,엘림헤어샵,1,1,1,3
12488,s18491366,18491366,더보이 본점,1,1,1,3
12489,s18432907,18432907,배금자미용실,1,1,1,3
12490,s11729787,11729787,블루클럽 오류점,1,1,1,3
12491,s766208980,766208980,H스타일 신도림점,1,1,1,3
12492,s1275507221,1275507221,머리꾸미기,1,1,1,3
12493,s1055992384,1055992384,미가헤어라인,1,1,1,3
12494,s1194814350,1194814350,사라임미용실,1,1,1,3
12495,s20929525,20929525,비엔나헤어샵,1,1,1,3
12496,s20849290,20849290,가은헤어클리닉,1,1,1,3
12497,s20841292,20841292,컷트클럽궁동점,1,1,1,3
12498,s1515416635,1515416635,체리헤어,1,1,1,3
12499,s20856784,20856784,은깨비미용실,1,1,1,3
12500,s20898984,20898984,글로리아미용실,1,1,1,3
12501,s35516594,35516594,살롱라피네,1,1,1,3
12502,s20918173,20918173,미좋은느낌,1,1,1,3
12503,s1671658980,1671658980,이재은헤어,1,1,1,3
12504,s20872304,20872304,UP헤어,1,1,1,3
12505,s11697347,11697347,박헤어라인,1,1,1,3
12506,s18485806,18485806,헤어어딕트,1,1,1,3
12507,s20864740,20864740,가위소리미용실,1,1,1,3
12508,s1732836040,1732836040,미미헤어,1,1,1,3
12509,s20853008,20853008,허브헤어,1,1,1,3
12510,s20914309,20914309,쌍둥이네헤어샵,1,1,1,3
12511,s20845314,20845314,또또와미용실,1,1,1,3
12512,s20914349,20914349,이레미장,1,1,1,3
12513,s20910649,20910649,제일미용실,1,1,1,3
12514,s1092885534,1092885534,명헤어,1,1,1,3
12515,s20864670,20864670,골드헤어샵,1,1,1,3
12516,s36005249,36005249,그래서미용실,1,1,1,3
12517,s20872172,20872172,꾸미지헤어,1,1,1,3
12518,s1798253476,1798253476,헤어터치,1,1,1,3
12519,s20841368,20841368,서지혜헤어필,1,1,1,3
12520,s20902851,20902851,머리멋내기,1,1,1,3
12521,s18494290,18494290,황이수헤어겔러리,1,1,1,3
12522,s1402290248,1402290248,개봉살롱,1,1,1,3
12523,s34907163,34907163,QueenHair,1,1,1,3
12524,s20940898,20940898,홍성희헤어샵,1,1,1,3
12525,s20884001,20884001,ZIOHair,1,1,1,3
12526,s1730305203,1730305203,금은미용실,1,1,1,3
12527,s1588375214,1588375214,헤어톡톡,1,1,1,3
12528,s1132427990,1132427990,굿모닝헤어,1,1,1,3
12529,s1129484550,1129484550,장서희헤어칼라,1,1,1,3
12530,s34354991,34354991,루킹헤어,1,1,1,3
12531,s20940871,20940871,신데렐라,1,1,1,3
12532,s20921845,20921845,칠보단장헤어샵,1,1,1,3
12533,s20884031,20884031,은호헤어갤러리,1,1,1,3
12534,s19408937,19408937,정미용실,1,1,1,3
12535,s31305892,31305892,로즈마리헤어,1,1,1,3
12536,s1005090551,1005090551,에벤에셀헤어샵,1,1,1,3
12537,s1260435539,1260435539,클레오파트라,1,1,1,3
12538,s20895201,20895201,가위소리헤어,1,1,1,3
12539,s20856655,20856655,주연헤어샵,1,1,1,3
12540,s20864656,20864656,여성의도시헤어뱅크,1,1,1,3
12541,s18961490,18961490,도도헤어콜렉션,1,1,1,3
12542,s20887725,20887725,버르장머리,1,1,1,3
12543,s1058448372,1058448372,e-헤어,1,1,1,3
12544,s18454540,18454540,미소유,1,1,1,3
12545,s1715922280,1715922280,탐나헤어,1,1,1,3
12546,s1564505434,1564505434,뿜헤어,1,1,1,3
12547,s1818578695,1818578695,레드헤어,1,1,1,3
12548,s11480239,11480239,조효숙미용실,1,1,1,3
12549,s1574432507,1574432507,창포헤어,1,1,1,3
12550,s34922582,34922582,하얀헤어,1,1,1,3
12551,s1164728491,1164728491,타임플러스 개봉푸르지오점,1,1,1,3
12552,s20914342,20914342,하니헤어리더,1,1,1,3
12553,s36939935,36939935,꽃단장헤어,1,1,1,3
12554,s1309762416,1309762416,란헤어,1,1,1,3
12555,s20918125,20918125,김미숙헤어샵,1,1,1,3
12556,s1916046797,1916046797,미니미니HAIR,1,1,1,3
12557,s11660170,11660170,남선교헤어토크,1,1,1,3
12558,s1825248520,1825248520,아뜨리에,1,1,1,3
12559,s20887680,20887680,소망헤어샵,1,1,1,3
12560,s1124683126,1124683126,Heyjoo hair salon,1,1,1,3
12561,s18454536,18454536,멋내기터,1,1,1,3
12562,s1153602362,1153602362,아름헤어샵,1,1,1,3
12563,s20933449,20933449,기분좋은날,1,1,1,3
12564,s18969761,18969761,에어로헤어살롱1호점,1,1,1,3
12565,s1082880469,1082880469,머리하는날,1,1,1,3
12566,s1358146798,1358146798,체인지헤어샵,1,1,1,3
12567,s1635811761,1635811761,은머리방,1,1,1,3
12568,s1386556082,1386556082,최진경헤어갤러리,1,1,1,3
12569,s1998802965,1998802965,보기 헤어,1,1,1,3
12570,s21235530,21235530,JMJ 헤어,1,1,1,3
12571,s20933463,20933463,헤어갤러리,1,1,1,3
12572,s20880100,20880100,헤어플러스,1,1,1,3
12573,s1054163726,1054163726,윤미용실,1,1,1,3
12574,s1188406500,1188406500,멋내기터,1,1,1,3
12575,s20849078,20849078,미성헤어타운,1,1,1,3
12576,s1458888293,1458888293,찰리장헤어뉴스,1,1,1,3
12577,s20906674,20906674,블루클럽 개봉역점,1,1,1,3
12578,s18475496,18475496,머리하는곳,1,1,1,3
12579,s19417482,19417482,머리나라,1,1,1,3
12580,s20856640,20856640,컷트클럽미용실,1,1,1,3
12581,s20852851,20852851,인숙헤어라인,1,1,1,3
12582,s36005231,36005231,미미미용실,1,1,1,3
12583,s20837674,20837674,박선정헤어크리닉,1,1,1,3
12584,s1579582385,1579582385,김재숙헤어클리닉,1,1,1,3
12585,s18490224,18490224,김은식헤어샵,1,1,1,3
12586,s1875262693,1875262693,YOU헤어연출,1,1,1,3
12587,s13150712,13150712,소다미용실,1,1,1,3
12588,s20855515,20855515,소다헤어디자인,1,1,1,3
12589,s1910535600,1910535600,수림헤어,1,1,1,3
12590,s35782297,35782297,한스헤어뱅크,1,1,1,3
12591,s20833575,20833575,귀빈머리방,1,1,1,3
12592,s20876305,20876305,까꼬뽀꼬미용실,1,1,1,3
12593,s38635547,38635547,김혜정헤어스튜디오,1,1,1,3
12594,s20829728,20829728,댕기머리미용실,1,1,1,3
12595,s38562980,38562980,헤어팡팡,1,1,1,3
12596,s18488123,18488123,명헤어숍,1,1,1,3
12597,s1676766853,1676766853,개성시대헤어샵,1,1,1,3
12598,s35444609,35444609,오드리햅번,1,1,1,3
12599,s1897257096,1897257096,그린미용실,1,1,1,3
12600,s32101235,32101235,머리만들기미용실,1,1,1,3
12601,s18458817,18458817,머리여울미용실,1,1,1,3
12602,s20821814,20821814,신아헤어갤러리,1,1,1,3
12603,s18487294,18487294,화이트헤어클럽,1,1,1,3
12604,s1984674400,1984674400,심순임헤어포인트,1,1,1,3
12605,s37026032,37026032,태후사랑 구로점,1,1,1,3
12606,s20895097,20895097,초이헤어뱅크,1,1,1,3
12607,s1064832947,1064832947,세빈헤어,1,1,1,3
12608,s20829654,20829654,헤어스토리,1,1,1,3
12609,s20918031,20918031,헤어도우미,1,1,1,3
12610,s20940915,20940915,술람미헤어샵,1,1,1,3
12611,s18970904,18970904,조연복헤어숍,1,1,1,3
12612,s18432883,18432883,글로리아미용실,1,1,1,3
12613,s20880138,20880138,헤어리더,1,1,1,3
12614,s20925561,20925561,신데렐라미용실,1,1,1,3
12615,s1243232096,1243232096,머리마을미용실,1,1,1,3
12616,s1111979655,1111979655,해바라기미용실,1,1,1,3
12617,s1948796980,1948796980,대세계미용실,1,1,1,3
12618,s1855160052,1855160052,민주헤어,1,1,1,3
12619,s1917664300,1917664300,선미용실,1,1,1,3
12620,s1405512818,1405512818,김영순헤어모드,1,1,1,3
12621,s1655052731,1655052731,살롱BJ,1,1,1,3
12622,s18451653,18451653,여의헤어,1,1,1,3
12623,s1542715625,1542715625,성성미헤어,1,1,1,3
12624,s20925640,20925640,장미헤어샵,1,1,1,3
12625,s20841296,20841296,수미헤어,1,1,1,3
12626,s20829835,20829835,홍진미용실,1,1,1,3
12627,s20899009,20899009,런던헤어샵,1,1,1,3
12628,s20825745,20825745,주영헤어,1,1,1,3
12629,s18432910,18432910,헤어모드,1,1,1,3
12630,s20841345,20841345,헤어5.5,1,1,1,3
12631,s1702256444,1702256444,혜성미용실,1,1,1,3
12632,s20829934,20829934,박장가위미용실,1,1,1,3
12633,s1797274498,1797274498,민들레헤어샵,1,1,1,3
12634,s20825659,20825659,이경희헤어샵,1,1,1,3
12635,s20841498,20841498,오투헤어플러스,1,1,1,3
12636,s11729786,11729786,블루클럽 신도림점,1,1,1,3
12637,s18959662,18959662,띠앗머리,1,1,1,3
12638,s1712995075,1712995075,초이헤어샵,1,1,1,3
12639,s20902882,20902882,삼환미용실,1,1,1,3
12640,s1595514180,1595514180,금화헤어샾,1,1,1,3
12641,s20918139,20918139,hairflair,1,1,1,3
12642,s20933432,20933432,제이헤어클리닉,1,1,1,3
12643,s1905380958,1905380958,필헤어라인,1,1,1,3
12644,s35545869,35545869,이즈헤어,1,1,1,3
12645,s20902784,20902784,헤어센스연출,1,1,1,3
12646,s1618613662,1618613662,S선헤어샵,1,1,1,3
12647,s1153347781,1153347781,파마나라,1,1,1,3
12648,s20849122,20849122,윤헤어클럽,1,1,1,3
12649,s20825657,20825657,마루마리,1,1,1,3
12650,s19501037,19501037,M헤어,1,1,1,3
12651,s1299898203,1299898203,m헤어,1,1,1,3
12652,s1529658046,1529658046,살롱드M,1,1,1,3
12653,s13583105,13583105,엠스타일,1,1,1,3
12654,s18972104,18972104,가위손미용실,1,1,1,3
12655,s18961234,18961234,베스트헤어샵,1,1,1,3
12656,s1295040274,1295040274,윤머리방,1,1,1,3
12657,s1886212069,1886212069,박상희미용실,1,1,1,3
12658,s20899070,20899070,노랑머리미용실,1,1,1,3
12659,s1260171648,1260171648,김연화헤어숍,1,1,1,3
12660,s1089042834,1089042834,우리미용타운,1,1,1,3
12661,s37725995,37725995,헤어벨 중계점,1,1,1,3
12662,s20904695,20904695,파스텔헤어샵,1,1,1,3
12663,s18627347,18627347,최혜진헤어터치,1,1,1,3
12664,s20866352,20866352,토마토헤어,1,1,1,3
12665,s34975184,34975184,올리브헤어미용실,1,1,1,3
12666,s18620113,18620113,하충희헤어,1,1,1,3
12667,s17996287,17996287,필헤어,1,1,1,3
12668,s1916332073,1916332073,엣지헤어앤네일,1,1,1,3
12669,s1447059625,1447059625,팜므헤어&메이크업,1,1,1,3
12670,s38557679,38557679,나이스가이 창동점,1,1,1,3
12671,s20908611,20908611,사라헤어,1,1,1,3
12672,s1082529622,1082529622,헤어201,1,1,1,3
12673,s18629592,18629592,윤주헤어샵,1,1,1,3
12674,s1183146967,1183146967,수정미용실,1,1,1,3
12675,s32167311,32167311,헤어코코창동점,1,1,1,3
12676,s20938974,20938974,궁헤어샵,1,1,1,3
12677,s18633263,18633263,휘미용실,1,1,1,3
12678,s17991913,17991913,아신헤어,1,1,1,3
12679,s20916066,20916066,헤어스케치,1,1,1,3
12680,s21581948,21581948,헤어스케치마벨,1,1,1,3
12681,s20923339,20923339,정헤어,1,1,1,3
12682,s32713613,32713613,초콜렛미용실,1,1,1,3
12683,s20942637,20942637,꽁지머리 쌍문점,1,1,1,3
12684,s1265712688,1265712688,이연헤어,1,1,1,3
12685,s37108489,37108489,501헤어all 창동점,1,1,1,3
12686,s31392396,31392396,정재윤미용실,1,1,1,3
12687,s1359823847,1359823847,조무겸헤어,1,1,1,3
12688,s1980019353,1980019353,파마해요,1,1,1,3
12689,s20866456,20866456,다움헤어,1,1,1,3
12690,s1005623213,1005623213,애니헤어,1,1,1,3
12691,s20916059,20916059,블루클럽LG트윈빌점,1,1,1,3
12692,s1153241777,1153241777,예인헤어살롱,1,1,1,3
12693,s1961956239,1961956239,한솔헤어컷,1,1,1,3
12694,s20850951,20850951,그린미용타운,1,1,1,3
12695,s1192116301,1192116301,남성컷 쿨헤어,1,1,1,3
12696,s1936603715,1936603715,한가희헤어샵,1,1,1,3
12697,s1401609066,1401609066,1029헤어클럽,1,1,1,3
12698,s20862612,20862612,채영HairForYou,1,1,1,3
12699,s20835512,20835512,헤어포유쌍문점,1,1,1,3
12700,s20942361,20942361,보보헤어,1,1,1,3
12701,s1519483270,1519483270,붐헤어,1,1,1,3
12702,s31547331,31547331,포시즌헤어,1,1,1,3
12703,s20942709,20942709,코드헤어,1,1,1,3
12704,s1631118951,1631118951,미헤어샵,1,1,1,3
12705,s20835464,20835464,미를즐기는사람들,1,1,1,3
12706,s18620428,18620428,미헤어공간,1,1,1,3
12707,s36005258,36005258,마르떼헤어,1,1,1,3
12708,s31730166,31730166,e헤어,1,1,1,3
12709,s1459680524,1459680524,아이리스 헤어,1,1,1,3
12710,s1199159546,1199159546,김도연헤어,1,1,1,3
12711,s20835097,20835097,비전앤헤어 신창점,1,1,1,3
12712,s1439310187,1439310187,최미용실,1,1,1,3
12713,s20930959,20930959,다담헤어,1,1,1,3
12714,s36236422,36236422,헤어프렌즈,1,1,1,3
12715,s37485444,37485444,헤어153가이드,1,1,1,3
12716,s1565814198,1565814198,오드리햅번,1,1,1,3
12717,s20831698,20831698,머리향기,1,1,1,3
12718,s20843159,20843159,아리아헤어 창동점,1,1,1,3
12719,s1604038537,1604038537,머리하는날,1,1,1,3
12720,s21093957,21093957,머리사랑미용실,1,1,1,3
12721,s1122858972,1122858972,쉬즈헤어,1,1,1,3
12722,s38510804,38510804,박훈헤어,1,1,1,3
12723,s542504910,542504910,유경헤어,1,1,1,3
12724,s1828783105,1828783105,진헤어샵,1,1,1,3
12725,s1467073462,1467073462,세븐헤어샵,1,1,1,3
12726,s31393958,31393958,에스헤어신창점,1,1,1,3
12727,s1646718113,1646718113,헤어갤러리,1,1,1,3
12728,s1107321301,1107321301,르호봇헤어클럽,1,1,1,3
12729,s20935173,20935173,헤어에비뉴,1,1,1,3
12730,s20827722,20827722,마니끌레,1,1,1,3
12731,s20927500,20927500,토마토헤어 쌍문점,1,1,1,3
12732,s20858608,20858608,죠이헤어클럽,1,1,1,3
12733,s1477376298,1477376298,명희머리방,1,1,1,3
12734,s13341999,13341999,울프샵,1,1,1,3
12735,s20900888,20900888,성희미용실,1,1,1,3
12736,s20866473,20866473,헤어마루,1,1,1,3
12737,s13520873,13520873,도도헤어,1,1,1,3
12738,s1429672667,1429672667,쥬쥬헤어,1,1,1,3
12739,s1633564600,1633564600,명품머리결,1,1,1,3
12740,s1939776512,1939776512,브니엘 헤어,1,1,1,3
12741,s1669905862,1669905862,이레헤어,1,1,1,3
12742,s20939065,20939065,호야헤어&피부,1,1,1,3
12743,s1464419734,1464419734,영미용실,1,1,1,3
12744,s32333028,32333028,미랑컬헤어 창동역점,1,1,1,3
12745,s20858677,20858677,박연헤어,1,1,1,3
12746,s1333479053,1333479053,헤어플러스,1,1,1,3
12747,s20839403,20839403,크라크라헤어,1,1,1,3
12748,s20919746,20919746,수하미헤어,1,1,1,3
12749,s1741675138,1741675138,다올헤어,1,1,1,3
12750,s37495471,37495471,조윤정 헤어클리닉,1,1,1,3
12751,s1990144509,1990144509,수헤어숍,1,1,1,3
12752,s1527167536,1527167536,수헤어,1,1,1,3
12753,s20942630,20942630,YOU헤어뱅크,1,1,1,3
12754,s1092945546,1092945546,여우머리미용실,1,1,1,3
12755,s20919780,20919780,최윤정미용실,1,1,1,3
12756,s20942850,20942850,박영희머리마을,1,1,1,3
12757,s17974062,17974062,쎄미미용실,1,1,1,3
12758,s18633456,18633456,김범헤어,1,1,1,3
12759,s20916247,20916247,가림헤어라인,1,1,1,3
12760,s17991509,17991509,여왕미용실,1,1,1,3
12761,s17991521,17991521,단발머리,1,1,1,3
12762,s1540516790,1540516790,김민기프로헤어,1,1,1,3
12763,s20858556,20858556,명동헤어필,1,1,1,3
12764,s13534692,13534692,신데렐라미용실,1,1,1,3
12765,s1192050392,1192050392,머리사랑,1,1,1,3
12766,s1120739560,1120739560,블루샤,1,1,1,3
12767,s155220590,155220590,복윤서헤어클럽,1,1,1,3
12768,s1032828823,1032828823,오옥희헤어샵,1,1,1,3
12769,s1297456049,1297456049,도도헤어클럽,1,1,1,3
12770,s13285622,13285622,미앤미헤어,1,1,1,3
12771,s17974045,17974045,류문희헤어탑,1,1,1,3
12772,s20870379,20870379,헤라미용실,1,1,1,3
12773,s1732594750,1732594750,미용실숙희,1,1,1,3
12774,s20823223,20823223,조희경헤어,1,1,1,3
12775,s1522655738,1522655738,김윤주헤어,1,1,1,3
12776,s18620005,18620005,가시버시,1,1,1,3
12777,s20939004,20939004,헤어갤러리,1,1,1,3
12778,s18619320,18619320,W헤어,1,1,1,3
12779,s17954782,17954782,헤어파크,1,1,1,3
12780,s18623127,18623127,헤어리페어,1,1,1,3
12781,s20900992,20900992,김현헤어샵,1,1,1,3
12782,s1652992458,1652992458,도깨비미용실,1,1,1,3
12783,s20878053,20878053,주연미용실,1,1,1,3
12784,s1332595091,1332595091,빈스헤어,1,1,1,3
12785,s17991523,17991523,난초헤어컬렉션,1,1,1,3
12786,s34644661,34644661,그린헤어,1,1,1,3
12787,s1147413062,1147413062,헤어연출,1,1,1,3
12788,s20866290,20866290,원민지헤어스튜디오,1,1,1,3
12789,s1189929556,1189929556,미헤어라인,1,1,1,3
12790,s20916259,20916259,백조미용실,1,1,1,3
12791,s19409815,19409815,에스더미용실,1,1,1,3
12792,s20904694,20904694,구구미용실,1,1,1,3
12793,s17995936,17995936,팜팜미용실,1,1,1,3
12794,s20874193,20874193,다희미용실,1,1,1,3
12795,s20854677,20854677,호영숙머리방,1,1,1,3
12796,s18619998,18619998,민경미용실,1,1,1,3
12797,s20893407,20893407,샬롬미용실,1,1,1,3
12798,s1704214145,1704214145,도로시헤어,1,1,1,3
12799,s1965008284,1965008284,온스타일,1,1,1,3
12800,s1220365258,1220365258,나인헤어,1,1,1,3
12801,s18633544,18633544,리우헤어샵,1,1,1,3
12802,s18631212,18631212,오렌지헤어클럽,1,1,1,3
12803,s18619438,18619438,나나헤어아트,1,1,1,3
12804,s20870347,20870347,머리사랑,1,1,1,3
12805,s38724947,38724947,안다미로 헤어살롱,1,1,1,3
12806,s20378886,20378886,hair doo,1,1,1,3
12807,s18632619,18632619,세리미용실,1,1,1,3
12808,s20873988,20873988,머리짱,1,1,1,3
12809,s1401765640,1401765640,센스미용실,1,1,1,3
12810,s20942815,20942815,거북미용실,1,1,1,3
12811,s1782280245,1782280245,마시모헤어,1,1,1,3
12812,s17994597,17994597,신세계헤어,1,1,1,3
12813,s38463027,38463027,고운머리미용실,1,1,1,3
12814,s18630138,18630138,샤샤헤어샵,1,1,1,3
12815,s11729872,11729872,블루클럽 창동점,1,1,1,3
12816,s18632332,18632332,헤어스케치,1,1,1,3
12817,s17998217,17998217,자매미용실,1,1,1,3
12818,s17982802,17982802,산리쯔헤어 도봉점,1,1,1,3
12819,s1239720966,1239720966,이지헤어,1,1,1,3
12820,s20897020,20897020,오투헤어 방학점,1,1,1,3
12821,s20843206,20843206,서영이가위소리,1,1,1,3
12822,s18628059,18628059,최재림미용타운,1,1,1,3
12823,s1569691035,1569691035,최인비미용실,1,1,1,3
12824,s31391290,31391290,블루클럽 쌍문점,1,1,1,3
12825,s20916262,20916262,한울머리터,1,1,1,3
12826,s1205598282,1205598282,머리깍자,1,1,1,3
12827,s1562837009,1562837009,고은주헤어뉴스,1,1,1,3
12828,s31154221,31154221,힐링헤어,1,1,1,3
12829,s1098489529,1098489529,질경이와함께하는조은염색,1,1,1,3
12830,s190204427,190204427,서울미용실,1,1,1,3
12831,s20831634,20831634,리체헤어,1,1,1,3
12832,s1592428317,1592428317,한솔미용실,1,1,1,3
12833,s1127200061,1127200061,헤어플러스,1,1,1,3
12834,s18001738,18001738,에이스미용실,1,1,1,3
12835,s1435157669,1435157669,와이미용실,1,1,1,3
12836,s17964912,17964912,티나헤어미용실,1,1,1,3
12837,s1210302845,1210302845,영헤어,1,1,1,3
12838,s32167131,32167131,핀컬스토리헤어,1,1,1,3
12839,s18624975,18624975,산리쯔헤어,1,1,1,3
12840,s18632410,18632410,샘미용실,1,1,1,3
12841,s20831525,20831525,고헤어샵,1,1,1,3
12842,s1011290222,1011290222,이훈ALL30000 쌍문점,1,1,1,3
12843,s17954776,17954776,펌앤컷,1,1,1,3
12844,s1203097852,1203097852,최준 헤어매니아,1,1,1,3
12845,s918240166,918240166,샤기헤어2호점,1,1,1,3
12846,s1884053241,1884053241,까까보까,1,1,1,3
12847,s32566081,32566081,아토헤어,1,1,1,3
12848,s1726561063,1726561063,오땡큐미용실,1,1,1,3
12849,s1511477677,1511477677,다온헤어,1,1,1,3
12850,s18625420,18625420,남영숙미용타운,1,1,1,3
12851,s1392876738,1392876738,머리사랑헤어,1,1,1,3
12852,s18624980,18624980,나드리헤어,1,1,1,3
12853,s20862515,20862515,도도헤어,1,1,1,3
12854,s11381564,11381564,윤기자 미용실,1,1,1,3
12855,s1737801521,1737801521,신디헤어,1,1,1,3
12856,s1968062368,1968062368,마니아헤어,1,1,1,3
12857,s1194627621,1194627621,끌리네미용실,1,1,1,3
12858,s1282197189,1282197189,김지원헤어,1,1,1,3
12859,s1059142333,1059142333,샘터헤어샵,1,1,1,3
12860,s37775976,37775976,김은희 미용실,1,1,1,3
12861,s1199333307,1199333307,라임헤어,1,1,1,3
12862,s1306028484,1306028484,젠틀맨클럽,1,1,1,3
12863,s1004052927,1004052927,감동헤어,1,1,1,3
12864,s37571898,37571898,쿠지헤어,1,1,1,3
12865,s1475263256,1475263256,JJ헤어,1,1,1,3
12866,s1208062076,1208062076,Hair 바람,1,1,1,3
12867,s1761244015,1761244015,헤어바람,1,1,1,3
12868,s32166819,32166819,삼이샵,1,1,1,3
12869,s13187930,13187930,세림미용실,1,1,1,3
12870,s1623238853,1623238853,행복미용실,1,1,1,3
12871,s17999535,17999535,컷앤펌,1,1,1,3
12872,s1178806914,1178806914,민헤어,1,1,1,3
12873,s18625438,18625438,어울림,1,1,1,3
12874,s1099620151,1099620151,헤어코디,1,1,1,3
12875,s1607257519,1607257519,연지헤어,1,1,1,3
12876,s37603333,37603333,유은헤어,1,1,1,3
12877,s1223390710,1223390710,헤어천사,1,1,1,3
12878,s1337849351,1337849351,JU헤어,1,1,1,3
12879,s18625695,18625695,차연희헤어코디,1,1,1,3
12880,s1314951843,1314951843,원헤어플러스,1,1,1,3
12881,s37802693,37802693,줄리헤어샵,1,1,1,3
12882,s38218130,38218130,더 헤어,1,1,1,3
12883,s1258216692,1258216692,에스더헤어,1,1,1,3
12884,s1036854151,1036854151,오드리헤어,1,1,1,3
12885,s1433963438,1433963438,온스타일,1,1,1,3
12886,s1671649280,1671649280,제이슨헤어 4호점,1,1,1,3
12887,s718161398,718161398,헤어랩아지트,1,1,1,3
12888,s1405107448,1405107448,더헤어,1,1,1,3
12889,s37495398,37495398,콤마제이헤어,1,1,1,3
12890,s1840372147,1840372147,머리,1,1,1,3
12891,s20923680,20923680,홍미용실,1,1,1,3
12892,s1310481279,1310481279,윤봄헤어,1,1,1,3
12893,s1279280064,1279280064,리아르떼 헤어,1,1,1,3
12894,s1038333694,1038333694,살롱드홍헤어,1,1,1,3
12895,s1848973086,1848973086,예쁘다헤어,1,1,1,3
12896,s1589301553,1589301553,자연빛깔 쌍문점,1,1,1,3
12897,s1207323507,1207323507,아르보 헤어,1,1,1,3
12898,s516700012,516700012,헤어빈스미용실,1,1,1,3
12899,s1787048856,1787048856,헤어야,1,1,1,3
12900,s1805427287,1805427287,쿠찌헤어,1,1,1,3
12901,s1209035966,1209035966,포도쉬즈미 방학점,1,1,1,3
12902,s1181683950,1181683950,바너스 헤어,1,1,1,3
12903,s1031175354,1031175354,프롬 헤어,1,1,1,3
12904,s35403193,35403193,뷰티레이미용실,1,1,1,3
12905,s20847264,20847264,미&컬미용실,1,1,1,3
12906,s1790591401,1790591401,비비헤어,1,1,1,3
12907,s20862496,20862496,세리미용실,1,1,1,3
12908,s20901008,20901008,수지헤어샵,1,1,1,3
12909,s1675467073,1675467073,강민주헤어,1,1,1,3
12910,s1251623634,1251623634,수앤지헤어샵,1,1,1,3
12911,s20827726,20827726,너네가찾는미용실,1,1,1,3
12912,s1224985541,1224985541,다온헤어,1,1,1,3
12913,s20831636,20831636,황실머리방,1,1,1,3
12914,s1421782392,1421782392,리토헤어샵,1,1,1,3
12915,s20870265,20870265,현대미용실,1,1,1,3
12916,s1130240648,1130240648,비비헤어,1,1,1,3
12917,s20916155,20916155,지윤헤어아트,1,1,1,3
12918,s1142557402,1142557402,헤어 수,1,1,1,3
12919,s1938712004,1938712004,준희헤어,1,1,1,3
12920,s1138621543,1138621543,봄봄헤어,1,1,1,3
12921,s1311201264,1311201264,라르떼헤어,1,1,1,3
12922,s1430477781,1430477781,라르테헤어,1,1,1,3
12923,s1677703501,1677703501,예쁘다미용실,1,1,1,3
12924,s20858510,20858510,예쁘다헤어,1,1,1,3
12925,s1310689985,1310689985,남성컷트전문,1,1,1,3
12926,s1697156286,1697156286,장헤어,1,1,1,3
12927,s1128213314,1128213314,조아헤어,1,1,1,3
12928,s17974059,17974059,최윤희헤어피아,1,1,1,3
12929,s1003907537,1003907537,댄디헤어,1,1,1,3
12930,s1660560006,1660560006,언니네미용실,1,1,1,3
12931,s1564967353,1564967353,보비쥬헤어,1,1,1,3
12932,s1867666136,1867666136,김송정머리터 by jain,1,1,1,3
12933,s1448223385,1448223385,오늘헤어살롱,1,1,1,3
12934,s1611485556,1611485556,댕댕이살롱,1,1,1,3
12935,s18629400,18629400,가우,1,1,1,3
12936,s20885577,20885577,컷트잘하는집,1,1,1,3
12937,s1771262386,1771262386,늘솜헤어,1,1,1,3
12938,s504896830,504896830,헤어벙커,1,1,1,3
12939,s1783301613,1783301613,퀸스헤어,1,1,1,3
12940,s1384111344,1384111344,마리,1,1,1,3
12941,s11729861,11729861,블루클럽 방학역점,1,1,1,3
12942,s11868905,11868905,렉시온헤어,1,1,1,3
12943,s1303073201,1303073201,우리미용실,1,1,1,3
12944,s31729195,31729195,아인헤어,1,1,1,3
12945,s1157046976,1157046976,더블유헤어앤스파,1,1,1,3
12946,s1261304823,1261304823,헤어시안,1,1,1,3
12947,s437201805,437201805,째쟁이헤어뱅크,1,1,1,3
12948,s1009278709,1009278709,수지헤어,1,1,1,3
12949,s31395139,31395139,클레오미용실,1,1,1,3
12950,s34351685,34351685,미사랑헤어모드,1,1,1,3
12951,s1566271971,1566271971,준헤어,1,1,1,3
12952,s1185121884,1185121884,수헤어샾,1,1,1,3
12953,s35262034,35262034,이경머리방,1,1,1,3
12954,s1759497207,1759497207,카미미용실,1,1,1,3
12955,s1071707000,1071707000,마이더스 바이 문,1,1,1,3
12956,s291909025,291909025,이엘헤어,1,1,1,3
12957,s1374135355,1374135355,비단미용실,1,1,1,3
12958,s20904708,20904708,진선미미용실,1,1,1,3
12959,s31936475,31936475,하모니헤어,1,1,1,3
12960,s86498158,86498158,글로우헤어,1,1,1,3
12961,s31395226,31395226,보니타헤어,1,1,1,3
12962,s17996923,17996923,JK작품헤어본점,1,1,1,3
12963,s311247115,311247115,헤어카페감동,1,1,1,3
12964,s31107948,31107948,S헤어,1,1,1,3
12965,s18627898,18627898,비욘세미용실,1,1,1,3
12966,s1256056158,1256056158,쉬즈미헤어도봉점,1,1,1,3
12967,s37264332,37264332,쉬즈미 토탈뷰티,1,1,1,3
12968,s32423907,32423907,유니크헤어,1,1,1,3
12969,s1436764927,1436764927,향기헤어,1,1,1,3
12970,s20931352,20931352,DC헤어클럽,1,1,1,3
12971,s20839167,20839167,미랑헤어,1,1,1,3
12972,s18634078,18634078,작품하나헤어샵,1,1,1,3
12973,s1402337521,1402337521,우리들헤어,1,1,1,3
12974,s35664249,35664249,봄날 헤어살롱,1,1,1,3
12975,s17989943,17989943,미장가,1,1,1,3
12976,s33060798,33060798,제이디헤어,1,1,1,3
12977,s33163632,33163632,나무헤어,1,1,1,3
12978,s1428750281,1428750281,다올헤어,1,1,1,3
12979,s1530807806,1530807806,이화령헤어컷,1,1,1,3
12980,s1344408013,1344408013,잘헤어,1,1,1,3
12981,s1955179754,1955179754,방학동미용실 패션헤어,1,1,1,3
12982,s1164552078,1164552078,가온누리헤어,1,1,1,3
12983,s1230365400,1230365400,온스타일헤어,1,1,1,3
12984,s1656216436,1656216436,stylist br,1,1,1,3
12985,s1232595052,1232595052,마리플러스 프리미엄 헤어샵,1,1,1,3
12986,s1125829558,1125829558,체인지미용실,1,1,1,3
12987,s1688156798,1688156798,라라헤어,1,1,1,3
12988,s20916004,20916004,유수경헤어,1,1,1,3
12989,s20854745,20854745,헤어톡,1,1,1,3
12990,s941657761,941657761,윤헤어,1,1,1,3
12991,s1681738478,1681738478,현진헤어,1,1,1,3
12992,s37268905,37268905,공감헤어,1,1,1,3
12993,s30829440,30829440,혜리헤어샵,1,1,1,3
12994,s1284513649,1284513649,JN헤어,1,1,1,3
12995,s1702872204,1702872204,메이난헤어,1,1,1,3
12996,s20881900,20881900,에바다헤어,1,1,1,3
12997,s1710339253,1710339253,헤어아트,1,1,1,3
12998,s1100582337,1100582337,머리이야기,1,1,1,3
12999,s37441762,37441762,김쌤헤어,1,1,1,3
13000,s1176760622,1176760622,미장원by김쌤,1,1,1,3
13001,s1733478428,1733478428,박영은미용실,1,1,1,3
13002,s37326805,37326805,맨남자전문미용실,1,1,1,3
13003,s1898236424,1898236424,이미지헤어,1,1,1,3
13004,s739287570,739287570,살롱드제이헤어,1,1,1,3
13005,s819556560,819556560,루시르헤어,1,1,1,3
13006,s20908629,20908629,최경숙헤어,1,1,1,3
13007,s1094389394,1094389394,꾸밈헤어,1,1,1,3
13008,s1752808483,1752808483,재ee헤어,1,1,1,3
13009,s20648820,20648820,창동 첼로미용실,1,1,1,3
13010,s1487885808,1487885808,레드헤어 2호점,1,1,1,3
13011,s1128737373,1128737373,진헤어샵,1,1,1,3
13012,s1704761294,1704761294,한수진헤어클럽,1,1,1,3
13013,s1232702536,1232702536,헤어스토리,1,1,1,3
13014,s1075373662,1075373662,지온헤어샵,1,1,1,3
13015,s1553756284,1553756284,온스타일 아델점,1,1,1,3
13016,s37382347,37382347,뷰티헤어,1,1,1,3
13017,s1722093081,1722093081,커스텀 헤어,1,1,1,3
13018,s1213736541,1213736541,JN헤어,1,1,1,3
13019,s1485108333,1485108333,아인헤어살롱,1,1,1,3
13020,s38407656,38407656,오드리헤어샵,1,1,1,3
13021,s31728769,31728769,이영애헤어샵,1,1,1,3
13022,s1074762252,1074762252,리즈스타일헤어,1,1,1,3
13023,s1399770197,1399770197,가인헤어,1,1,1,3
13024,s36688070,36688070,소담헤어,1,1,1,3
13025,s565775339,565775339,이찬헤어랜드,1,1,1,3
13026,sk17994603,k17994603,한미용실,1,1,1,3
13027,s1268797784,1268797784,상아 헤어,1,1,1,3
13028,s1570574192,1570574192,끌레도르헤어,1,1,1,3
13029,s1141860906,1141860906,클라라헤어샵,1,1,1,3
13030,s1479487122,1479487122,쉭시브미용실,1,1,1,3
13031,s17954789,17954789,조경옥미용실,1,1,1,3
13032,s34224178,34224178,김기선헤어샵,1,1,1,3
13033,s1768358358,1768358358,예소샵헤어,1,1,1,3
13034,s1884953248,1884953248,은헤어샵,1,1,1,3
13035,s20822665,20822665,헤어엣지,1,1,1,3
13036,s20926567,20926567,지우헤어,1,1,1,3
13037,s1710101394,1710101394,허니헤어,1,1,1,3
13038,s31730174,31730174,허니헤어,1,1,1,3
13039,s38467063,38467063,H헤어살롱 공릉점,1,1,1,3
13040,s1327129790,1327129790,머리앤봄,1,1,1,3
13041,s36665079,36665079,지&유헤어,1,1,1,3
13042,s1302441156,1302441156,지앤유헤어스토리,1,1,1,3
13043,s1526098441,1526098441,JJ헤어,1,1,1,3
13044,sk1713383736,k1713383736,태후사랑(헤어샵),1,1,1,3
13045,s18644379,18644379,머리세상,1,1,1,3
13046,s1037906417,1037906417,헤어에비오스,1,1,1,3
13047,s1874025157,1874025157,수헤어,1,1,1,3
13048,s20896075,20896075,당고개헤어샵,1,1,1,3
13049,s1020401937,1020401937,J헤어,1,1,1,3
13050,s1136087613,1136087613,씨티헤어,1,1,1,3
13051,s35685638,35685638,시크헤어,1,1,1,3
13052,s36005255,36005255,남성헤어컷,1,1,1,3
13053,s1282427011,1282427011,헤어사랑,1,1,1,3
13054,s1635855212,1635855212,향기미용실,1,1,1,3
13055,s20869537,20869537,영임미용실,1,1,1,3
13056,s35370218,35370218,수헤어,1,1,1,3
13057,s381734828,381734828,샹그리헤어,1,1,1,3
13058,s20934358,20934358,까까머리,1,1,1,3
13059,s1523635653,1523635653,새샘미용실,1,1,1,3
13060,s20911417,20911417,프리스타일,1,1,1,3
13061,s31093352,31093352,이준헤어 노원2호점,1,1,1,3
13062,s1820999938,1820999938,은헤어,1,1,1,3
13063,s1475496915,1475496915,헤어빌리지,1,1,1,3
13064,s1459002953,1459002953,이지헤어샵,1,1,1,3
13065,s20918883,20918883,시크릿헤어,1,1,1,3
13066,sk20115025,k20115025,귀티나,1,1,1,3
13067,s1070991505,1070991505,쏘파비엔에이치,1,1,1,3
13068,s31392857,31392857,헤어502,1,1,1,3
13069,s1199565137,1199565137,헤어파크,1,1,1,3
13070,s1274662910,1274662910,프리스타일,1,1,1,3
13071,s1588536095,1588536095,헤어까미,1,1,1,3
13072,s1979024632,1979024632,에스헤어,1,1,1,3
13073,s20786114,20786114,앤폴헤어,1,1,1,3
13074,s31383379,31383379,앤폴헤어 태희,1,1,1,3
13075,s1519563314,1519563314,제이헤어,1,1,1,3
13076,s33934551,33934551,감동,1,1,1,3
13077,s1846390721,1846390721,인헤어,1,1,1,3
13078,s18647897,18647897,헤어스케치,1,1,1,3
13079,s1566880682,1566880682,아델라헤어살롱,1,1,1,3
13080,s804204416,804204416,헤어라움,1,1,1,3
13081,s36763135,36763135,보떼헤어광운점,1,1,1,3
13082,s37171511,37171511,오드리헤어,1,1,1,3
13083,s1654395240,1654395240,샬롬헤어,1,1,1,3
13084,s37525407,37525407,꼬뺑헤어,1,1,1,3
13085,s37869756,37869756,시연헤어,1,1,1,3
13086,s37121076,37121076,작은미용실,1,1,1,3
13087,s20869403,20869403,민헤어,1,1,1,3
13088,s1843539435,1843539435,제이헤어,1,1,1,3
13089,s1495865361,1495865361,가이헤어,1,1,1,3
13090,s37288847,37288847,몽헤어,1,1,1,3
13091,s11721883,11721883,미사랑헤어,1,1,1,3
13092,s11729859,11729859,블루클럽 중계점,1,1,1,3
13093,s32891268,32891268,문헤어,1,1,1,3
13094,s1649921152,1649921152,까꼬뽀꼬미용실,1,1,1,3
13095,s1466073114,1466073114,레드켓헤어,1,1,1,3
13096,s32171705,32171705,용성헤어,1,1,1,3
13097,s1059303519,1059303519,지헤어,1,1,1,3
13098,s1492302789,1492302789,예뻐지는파마염색방,1,1,1,3
13099,s1045840054,1045840054,프린세스헤어,1,1,1,3
13100,s38481222,38481222,오현정헤어,1,1,1,3
13101,s37123212,37123212,아테나헤어,1,1,1,3
13102,s1596090399,1596090399,루체헤나,1,1,1,3
13103,s37432954,37432954,다올헤어,1,1,1,3
13104,s424827097,424827097,마르떼헤어,1,1,1,3
13105,s1795885489,1795885489,러블리헤어,1,1,1,3
13106,s1245065770,1245065770,구찌헤어,1,1,1,3
13107,s1449047328,1449047328,J헤어,1,1,1,3
13108,s1517068269,1517068269,엄정아미용실,1,1,1,3
13109,s32173280,32173280,칼라하우스,1,1,1,3
13110,s20826650,20826650,보라헤어클럽,1,1,1,3
13111,s1611394020,1611394020,준헤어,1,1,1,3
13112,s36213961,36213961,위스타헤어,1,1,1,3
13113,s37078236,37078236,헤어살롱수,1,1,1,3
13114,s36417385,36417385,TJ HAIR,1,1,1,3
13115,s830309567,830309567,재미헤어,1,1,1,3
13116,s36449035,36449035,180도헤어케어 상계점,1,1,1,3
13117,s37060776,37060776,Glam hair,1,1,1,3
13118,s36669152,36669152,S헤어,1,1,1,3
13119,s36740044,36740044,바이민헤어,1,1,1,3
13120,s36615307,36615307,이혜숙헤어샵,1,1,1,3
13121,s31805063,31805063,하나헤어클럽,1,1,1,3
13122,s20915291,20915291,헤어팡,1,1,1,3
13123,s18048870,18048870,선헤어스토리,1,1,1,3
13124,s11688221,11688221,소울헤어,1,1,1,3
13125,s38779573,38779573,키레이헤어,1,1,1,3
13126,s20861631,20861631,미가미장,1,1,1,3
13127,s37259100,37259100,이리스헤어,1,1,1,3
13128,s1805570204,1805570204,민헤어살롱,1,1,1,3
13129,s35095101,35095101,씰리헤어,1,1,1,3
13130,s1647535056,1647535056,안나헤어,1,1,1,3
13131,s18639380,18639380,재동헤어숍,1,1,1,3
13132,s19948953,19948953,황위란미용실,1,1,1,3
13133,s18059776,18059776,김민지헤어아트,1,1,1,3
13134,s1618637129,1618637129,센스헤어라인,1,1,1,3
13135,s20842396,20842396,우정미용실,1,1,1,3
13136,s1376186876,1376186876,미앤유헤어샵,1,1,1,3
13137,s18638511,18638511,김현아헤어라인,1,1,1,3
13138,s20876997,20876997,머리,1,1,1,3
13139,s18639467,18639467,깍끌래뽀끌래,1,1,1,3
13140,s18639596,18639596,이나경헤어코디,1,1,1,3
13141,s20900043,20900043,지향미용실,1,1,1,3
13142,s20926612,20926612,신데렐라머리이야기 공릉점,1,1,1,3
13143,s20934259,20934259,현아미용실,1,1,1,3
13144,s1261412637,1261412637,헤어화,1,1,1,3
13145,s36097573,36097573,W헤어,1,1,1,3
13146,s1101176146,1101176146,벨로뜨헤어,1,1,1,3
13147,s13151400,13151400,옥헤어라인,1,1,1,3
13148,s20888567,20888567,보나헤어,1,1,1,3
13149,s18004868,18004868,너네가찾던미용실,1,1,1,3
13150,s18024859,18024859,스플랜더헤어포유,1,1,1,3
13151,s1609231687,1609231687,은헤어,1,1,1,3
13152,s11839455,11839455,정민철헤어두,1,1,1,3
13153,s38510299,38510299,김보민헤어갤러리,1,1,1,3
13154,s1235191665,1235191665,컷트클럽,1,1,1,3
13155,s1792758579,1792758579,블루클럽 마들점,1,1,1,3
13156,s108162571,108162571,오땡큐 천연 헤나 머리 염색,1,1,1,3
13157,s32170589,32170589,LEE'S 미용실,1,1,1,3
13158,s11729819,11729819,블루클럽 노원점,1,1,1,3
13159,s38541609,38541609,뷰헤어,1,1,1,3
13160,s18650854,18650854,가이미용실,1,1,1,3
13161,s20903882,20903882,헤어통일,1,1,1,3
13162,s1766341255,1766341255,너의하루,1,1,1,3
13163,s31168983,31168983,나라헤어,1,1,1,3
13164,s35602003,35602003,Hair KUICHI,1,1,1,3
13165,s1090022791,1090022791,이플헤어,1,1,1,3
13166,s20896303,20896303,조인숙헤어샵,1,1,1,3
13167,s1429950833,1429950833,헤어붐,1,1,1,3
13168,s20907716,20907716,댕기헤어샵,1,1,1,3
13169,s1499380632,1499380632,엘리스헤어,1,1,1,3
13170,s1733947359,1733947359,우노헤어,1,1,1,3
13171,s36677555,36677555,최지현CHOI.J.H,1,1,1,3
13172,s20926480,20926480,야호헤어샵,1,1,1,3
13173,s1143583431,1143583431,에스헤어,1,1,1,3
13174,s33451888,33451888,쉼표헤어,1,1,1,3
13175,s20834408,20834408,리즈헤어,1,1,1,3
13176,s1852734649,1852734649,임숙희헤어샵,1,1,1,3
13177,s1445768099,1445768099,조미란헤어,1,1,1,3
13178,s20873362,20873362,김원숙헤어라인,1,1,1,3
13179,s1852249879,1852249879,토마토헤어미용실,1,1,1,3
13180,s1033929879,1033929879,더감동헤어,1,1,1,3
13181,s1553162495,1553162495,희원헤어,1,1,1,3
13182,s1280339440,1280339440,마르떼헤어,1,1,1,3
13183,s38681624,38681624,스타일헤어,1,1,1,3
13184,s37130279,37130279,클라라미용실,1,1,1,3
13185,s35234901,35234901,신데렐라 미용실,1,1,1,3
13186,s1830422450,1830422450,실비아헤어,1,1,1,3
13187,s1648282498,1648282498,이은희헤어,1,1,1,3
13188,s1326702300,1326702300,박희정미용실,1,1,1,3
13189,s1312186481,1312186481,헤어스케치,1,1,1,3
13190,s1669498556,1669498556,H헤어,1,1,1,3
13191,s18638516,18638516,헤어까페공릉점,1,1,1,3
13192,s1151358798,1151358798,영헤어,1,1,1,3
13193,s1520450730,1520450730,이정숙헤어샵,1,1,1,3
13194,s18641797,18641797,조연헤어,1,1,1,3
13195,s1067736691,1067736691,삐까삐까미용실,1,1,1,3
13196,s1272287026,1272287026,성연미용실,1,1,1,3
13197,s1344035424,1344035424,머리이야기,1,1,1,3
13198,s1875656369,1875656369,민들레헤어,1,1,1,3
13199,s260428233,260428233,이하연헤어,1,1,1,3
13200,s1382053200,1382053200,카라헤어,1,1,1,3
13201,s20911440,20911440,오정순헤어샵,1,1,1,3
13202,s1315234901,1315234901,최민헤어샵,1,1,1,3
13203,s11729860,11729860,블루클럽 하계역점,1,1,1,3
13204,s20880874,20880874,꽃바람미용실,1,1,1,3
13205,s1603406622,1603406622,이미지헤어샵,1,1,1,3
13206,s36308643,36308643,째즈헤어클럽,1,1,1,3
13207,s1952377938,1952377938,머리꾼헤어,1,1,1,3
13208,s1300864396,1300864396,머리꾼,1,1,1,3
13209,s1151291396,1151291396,마리헤어,1,1,1,3
13210,s20884870,20884870,머리만들기,1,1,1,3
13211,s20846290,20846290,토크&헤어,1,1,1,3
13212,s20846113,20846113,비쥬헤어,1,1,1,3
13213,s1141106187,1141106187,이리로헤어,1,1,1,3
13214,s20900108,20900108,헤어드레서,1,1,1,3
13215,s20897152,20897152,버들미용실,1,1,1,3
13216,s20942636,20942636,목화미용실,1,1,1,3
13217,s1882887987,1882887987,다인헤어,1,1,1,3
13218,s11715477,11715477,마리안 미용실,1,1,1,3
13219,s18001740,18001740,작품하나미용실,1,1,1,3
13220,s1936345630,1936345630,작품하나미용실,1,1,1,3
13221,s1255607954,1255607954,리즈헤어,1,1,1,3
13222,s965418665,965418665,The이쁜머리,1,1,1,3
13223,s1048204203,1048204203,정겨운머리방,1,1,1,3
13224,s20916206,20916206,채연헤어,1,1,1,3
13225,s37632490,37632490,까망머리도봉점,1,1,1,3
13226,s20889485,20889485,하라헤어,1,1,1,3
13227,s1148563699,1148563699,철수머리,1,1,1,3
13228,s18623761,18623761,카라뷰티헤어,1,1,1,3
13229,s1796647737,1796647737,올리브헤어방학점,1,1,1,3
13230,s1214032887,1214032887,멋진남자,1,1,1,3
13231,s20889569,20889569,소나무미용실,1,1,1,3
13232,s1084220160,1084220160,성은헤어,1,1,1,3
13233,s20843077,20843077,모던헤어 본점,1,1,1,3
13234,s1447296814,1447296814,착한헤어,1,1,1,3
13235,s18625578,18625578,미소헤어,1,1,1,3
13236,s1267887476,1267887476,마샬미용실,1,1,1,3
13237,s20858609,20858609,머리나라미용실,1,1,1,3
13238,s18625575,18625575,수정헤어샵,1,1,1,3
13239,s20839407,20839407,헤어센스,1,1,1,3
13240,s20919801,20919801,예인헤어,1,1,1,3
13241,s20862212,20862212,리라미용실,1,1,1,3
13242,s20843312,20843312,여성의도시미용실,1,1,1,3
13243,s20927324,20927324,축복미용실,1,1,1,3
13244,s20847082,20847082,모노헤어,1,1,1,3
13245,s20823424,20823424,진달래미용실,1,1,1,3
13246,s1397807419,1397807419,헤어드청춘,1,1,1,3
13247,s1100180724,1100180724,원헤어,1,1,1,3
13248,s20847043,20847043,바이송헤어,1,1,1,3
13249,s1842894580,1842894580,보노헤어,1,1,1,3
13250,s17995944,17995944,강태경프로헤어,1,1,1,3
13251,s20827506,20827506,도봉미용실,1,1,1,3
13252,s18635033,18635033,도도헤어,1,1,1,3
13253,s20919912,20919912,녹색미용실,1,1,1,3
13254,s20889447,20889447,맵시미용실,1,1,1,3
13255,s1740455293,1740455293,강미숙헤어,1,1,1,3
13256,s1159444402,1159444402,새마을미용실,1,1,1,3
13257,s20843340,20843340,유영미용실,1,1,1,3
13258,s17991517,17991517,박민헤어매직,1,1,1,3
13259,s1031324622,1031324622,현주미용실,1,1,1,3
13260,s1614252322,1614252322,원헤어,1,1,1,3
13261,s20938851,20938851,윤미용실,1,1,1,3
13262,s19415414,19415414,송헤어,1,1,1,3
13263,s1067237268,1067237268,도깨비머리,1,1,1,3
13264,s1198892406,1198892406,준희헤어,1,1,1,3
13265,s20831581,20831581,머리하는집,1,1,1,3
13266,s1709864770,1709864770,테오by실비아헤어,1,1,1,3
13267,s842625703,842625703,헤어앤헤어,1,1,1,3
13268,s20900807,20900807,연화헤어펌,1,1,1,3
13269,s17964893,17964893,에덴미용실,1,1,1,3
13270,s18623826,18623826,마르셀헤어,1,1,1,3
13271,s1283540533,1283540533,신현지미용실,1,1,1,3
13272,s1538045848,1538045848,헤이주헤어살롱,1,1,1,3
13273,s1487973842,1487973842,다올헤어,1,1,1,3
13274,s20870160,20870160,미인천하,1,1,1,3
13275,s1207005546,1207005546,최희헤어,1,1,1,3
13276,s1971245928,1971245928,비쥬헤어,1,1,1,3
13277,s20839336,20839336,까망머리방학점,1,1,1,3
13278,s36908797,36908797,태후사랑 방학점,1,1,1,3
13279,s18620438,18620438,윤주미용실,1,1,1,3
13280,s20889570,20889570,우정머리방,1,1,1,3
13281,s1126926568,1126926568,화씨방미용실,1,1,1,3
13282,s1221691989,1221691989,더예쁨헤어,1,1,1,3
13283,s1666656066,1666656066,커트치노,1,1,1,3
13284,s1035755373,1035755373,라라헤어,1,1,1,3
13285,s20973026,20973026,헤어프린스,1,1,1,3
13286,s1224063443,1224063443,이레헤어샵,1,1,1,3
13287,s18622977,18622977,무지개미용실,1,1,1,3
13288,s1380647498,1380647498,헤어스타일,1,1,1,3
13289,s20851047,20851047,아성헤어플러스,1,1,1,3
13290,s1193641402,1193641402,언니네헤어샵,1,1,1,3
13291,s1111960581,1111960581,다연헤어,1,1,1,3
13292,s1425895357,1425895357,가람헤어,1,1,1,3
13293,s20897210,20897210,아름다운미용실,1,1,1,3
13294,s11598196,11598196,김헤어펌 미용실,1,1,1,3
13295,s18623702,18623702,샤론헤어샵,1,1,1,3
13296,s1361206865,1361206865,황금빛미용실,1,1,1,3
13297,s1737210811,1737210811,백조미용실,1,1,1,3
13298,s17974054,17974054,정수빈헤어,1,1,1,3
13299,s1633623624,1633623624,딜런헤어,1,1,1,3
13300,s1004766953,1004766953,쿨헤어샵,1,1,1,3
13301,s1772342029,1772342029,헤어몬스터,1,1,1,3
13302,s37009138,37009138,모스헤어,1,1,1,3
13303,s18625294,18625294,이지헤어,1,1,1,3
13304,s19364767,19364767,라인헤어,1,1,1,3
13305,s1039497199,1039497199,오케이헤어샵,1,1,1,3
13306,s20908678,20908678,진선미미용실,1,1,1,3
13307,s1891385843,1891385843,보보스헤어,1,1,1,3
13308,s1230505269,1230505269,삼호미용실,1,1,1,3
13309,s1041243868,1041243868,와우헤어광운대역점,1,1,1,3
13310,s35838425,35838425,헤어누리,1,1,1,3
13311,s789574002,789574002,블랑쉬헤어,1,1,1,3
13312,s1980106714,1980106714,강남헤어갤러리,1,1,1,3
13313,s31393232,31393232,라니헤어,1,1,1,3
13314,s1884944788,1884944788,헤어컷느낌샵,1,1,1,3
13315,s1665227351,1665227351,승희헤어,1,1,1,3
13316,s1284431418,1284431418,가위소리,1,1,1,3
13317,s577056309,577056309,With hair,1,1,1,3
13318,s804202413,804202413,YOU&I Hair,1,1,1,3
13319,s1202013656,1202013656,씨엘헤어,1,1,1,3
13320,s37549128,37549128,구피샵 상계점,1,1,1,3
13321,s1553214385,1553214385,라인헤어,1,1,1,3
13322,s1529075177,1529075177,헤어세리아,1,1,1,3
13323,s1954653644,1954653644,미모헤어,1,1,1,3
13324,s1609182338,1609182338,모모헤어,1,1,1,3
13325,s1767191795,1767191795,헤어봉봉,1,1,1,3
13326,s1096214453,1096214453,은미용실,1,1,1,3
13327,s1252192331,1252192331,동네미용실,1,1,1,3
13328,s38554487,38554487,우리미용실,1,1,1,3
13329,s331551566,331551566,TETE 헤어샵,1,1,1,3
13330,s1992950004,1992950004,숨은미용실찾기,1,1,1,3
13331,s1183602806,1183602806,춘자쌀롱,1,1,1,3
13332,s1158119237,1158119237,라움헤어,1,1,1,3
13333,s38414808,38414808,jy헤어스토리,1,1,1,3
13334,s1896070396,1896070396,라온헤어,1,1,1,3
13335,s37797801,37797801,이미경헤어스토리,1,1,1,3
13336,s37936496,37936496,도도헤어,1,1,1,3
13337,s1071159014,1071159014,머리마을,1,1,1,3
13338,s81068218,81068218,샵식스 헤어,1,1,1,3
13339,s77843687,77843687,JD헤어,1,1,1,3
13340,s1691769806,1691769806,이엔헤어,1,1,1,3
13341,s1952774072,1952774072,다오헤어,1,1,1,3
13342,s552041186,552041186,HAIR180,1,1,1,3
13343,s1993656625,1993656625,사미살롱,1,1,1,3
13344,s706851535,706851535,와이앤지아트헤어,1,1,1,3
13345,s1869136938,1869136938,조아라미용실,1,1,1,3
13346,s20822646,20822646,지수헤어샵,1,1,1,3
13347,s48132308,48132308,김은연헤어,1,1,1,3
13348,s1145641716,1145641716,도도헤어,1,1,1,3
13349,s464843355,464843355,딜런헤어,1,1,1,3
13350,s601122540,601122540,헤라헤어,1,1,1,3
13351,s1635141598,1635141598,주은헤어,1,1,1,3
13352,s1164507901,1164507901,머리해요,1,1,1,3
13353,s20916232,20916232,은영미용실,1,1,1,3
13354,s1217017370,1217017370,마들헤어,1,1,1,3
13355,s1356318129,1356318129,큐사랑 염색방 중계점,1,1,1,3
13356,s1212641307,1212641307,멋더함헤어,1,1,1,3
13357,s1801600151,1801600151,칠링헤어,1,1,1,3
13358,s20922742,20922742,야베스헤어,1,1,1,3
13359,s1317591164,1317591164,다와머리염색 천연 염색방,1,1,1,3
13360,s1151879518,1151879518,아이예뻐라,1,1,1,3
13361,s18647257,18647257,제일미용실,1,1,1,3
13362,s1000368805,1000368805,큐사랑 공릉점,1,1,1,3
13363,s1615354774,1615354774,기분 좋은 염색,1,1,1,3
13364,s1731725669,1731725669,헤어스타,1,1,1,3
13365,s17998019,17998019,자기연출미용실,1,1,1,3
13366,s20847060,20847060,세나미용실,1,1,1,3
13367,s17997349,17997349,형제미용실,1,1,1,3
13368,s1217652276,1217652276,초원헤어샵,1,1,1,3
13369,s20847123,20847123,영미용실,1,1,1,3
13370,s17995950,17995950,조희미용타운,1,1,1,3
13371,s1349658411,1349658411,라라헤어,1,1,1,3
13372,s18635050,18635050,송민헤어,1,1,1,3
13373,s18623597,18623597,유리헤어클럽,1,1,1,3
13374,s1090182263,1090182263,우리미용실,1,1,1,3
13375,s1439838823,1439838823,반할헤어,1,1,1,3
13376,s1211266124,1211266124,아띠살롱,1,1,1,3
13377,s13066112,13066112,코드 광운대점,1,1,1,3
13378,s1352981571,1352981571,hair벨르,1,1,1,3
13379,s1329435674,1329435674,태양미용실,1,1,1,3
13380,s1848587262,1848587262,와이헤어샵,1,1,1,3
13381,s1648171466,1648171466,윤스헤어컬러샵,1,1,1,3
13382,s1973695153,1973695153,정미헤어,1,1,1,3
13383,s1013657976,1013657976,정인헤어,1,1,1,3
13384,s1248595749,1248595749,나나헤어,1,1,1,3
13385,s1975955849,1975955849,오묘한살롱,1,1,1,3
13386,s1178780367,1178780367,박효정헤어,1,1,1,3
13387,s36666153,36666153,행복한이야기,1,1,1,3
13388,s1315364686,1315364686,헤어영,1,1,1,3
13389,sk1271973095,k1271973095,아침에미용실,1,1,1,3
13390,s1179111470,1179111470,조은염색,1,1,1,3
13391,s1001796026,1001796026,헤어바이안기현,1,1,1,3
13392,s1673563639,1673563639,까미헤어,1,1,1,3
13393,s1141306946,1141306946,머리쫌헤어,1,1,1,3
13394,s1791818394,1791818394,하은헤어,1,1,1,3
13395,s1079802037,1079802037,늘봄헤어,1,1,1,3
13396,s31999100,31999100,h헤어,1,1,1,3
13397,s20834916,20834916,준 미용실,1,1,1,3
